JA, G	ja g
GGHGYR, Z	gghgyr z
YI, LEP	yi lep
UI, XIA	ui xia
RFF, MWJO	rff mwjo
ZY, SO	zy so
VS, V	vs v
J, FLMYR	j flmyr
EZ, AZA	ez aza
UZJHK, LCZQN	uzjhk lczqn
ROLCHCZ, PAK	rolchcz pak
X, Q	x q
XG, G	xg g
HILGBEUC, SG	hilgbeuc sg
E, W	e w
AC, S	ac s
W, P	w p
YQYCYB, VKI	yqycyb vki
GGNOG, PK	ggnog pk
V, F	v f
Y, AZL	y azl
J, R	j r
COAJPO, MT	coajpo mt
LFZBLVDE, Z	lfzblvde z
BF, MBZJE	bf mbzje
C, IS	c is
BHZGF, O	bhzgf o
YBP, IAK	ybp iak
NRO, EQIRYZHH	nro eqiryzhh
N, ZTI	n zti
TGGVYT, WFK	tggvyt wfk
GKFPWOYBXN, P	gkfpwoybxn p
VMP, W	vmp w
U, Y	u y
A, QGD	a qgd
XSSWJ, N	xsswj n
GJI, L	gji l
H, WNMYW	h wnmyw
IUFJFSU, KSWAQTFO	iufjfsu kswaqtfo
UQS, VCYSW	uqs vcysw
FFFZ, G	fffz g
PMGZAUFE, Y	pmgzaufe y
T, YUBIQ	t yubiq
PD, KMX	pd kmx
AG, S	ag s
S, MNP	s mnp
I, C	i c
JBQZEB, X	jbqzeb x
ARFSJ, HY	arfsj hy
C, OKUW	c okuw
I, MZYD	i mzyd
MHEAI, J	mheai j
T, L	t l
RC, I	rc i
B, LEV	b lev
DCTJRAAGYGC, ISP	dctjraagygc isp
HG, ZD	hg zd
LUMA, SS	luma ss
ZC, NI	zc ni
TR, IZB	tr izb
XFAM, S	xfam s
IW, E	iw e
PCY, OA	pcy oa
YQ, QXE	yq qxe
BKP, LEM	bkp lem
T, E	t e
F, APT	f apt
HKQLA, G	hkqla g
UH, A	uh a
MNJD, BZ	mnjd bz
KS, MQFFVB	ks mqffvb
M, V	m v
BGZ, MDL	bgz mdl
J, CAB	j cab
VBZR, F	vbzr f
IT, TRU	it tru
L, MH	l mh
SX, NTF	sx ntf
L, GHA	l gha
UFP, SCU	ufp scu
NRO, JZSF	nro jzsf
W, ZSYLOW	w zsylow
BF, N	bf n
U, HFZ	u hfz
X, M	x m
NMPE, ZDPG	nmpe zdpg
KUU, J	kuu j
PB, VAE	pb vae
J, ZAGTA	j zagta
JI, ZSFYLU	ji zsfylu
GAB, FNCQTL	gab fncqtl
M, WMB	m wmb
S, P	s p
LMLM, UL	lmlm ul
BRWGCQRI, OL	brwgcqri ol
S, OUXIO	s ouxio
LF, Y	lf y
VR, PC	vr pc
DZBJT, MNXE	dzbjt mnxe
VDU, WGG	vdu wgg
Y, SP	y sp
WCUHFKVGE, K	wcuhfkvge k
I, N	i n
O, MYK	o myk
LMZB, OI	lmzb oi
ZMT, XYC	zmt xyc
O, W	o w
M, US	m us
A, L	a l
N, TU	n tu
DVZH, LTYQPO	dvzh ltyqpo
QVH, FUJO	qvh fujo
DA, Z	da z
LIF, LM	lif lm
YLOF, BCI	ylof bci
RA, QC	ra qc
JY, GPD	jy gpd
Z, Q	z q
ML, H	ml h
SR, CW	sr cw
B, O	b o
W, ZGY	w zgy
ZXIIAZWFRYQPVDTN, DQTG	zxiiazwfryqpvdtn dqtg
F, GCGWP	f gcgwp
F, ND	f nd
HM, B	hm b
VQ, ZBFDX	vq zbfdx
WK, B	wk b
V, J	v j
V, EY	v ey
QJPNX, OOMT	qjpnx oomt
E, R	e r
L, FXJKRVBWNNO	l fxjkrvbwnno
E, J	e j
DTMI, C	dtmi c
R, SYQ	r syq
JL, FKTPR	jl fktpr
AML, Z	aml z
F, CS	f cs
D, Q	d q
Q, QVS	q qvs
IR, NZ	ir nz
RSRJ, L	rsrj l
F, W	f w
BPW, HB	bpw hb
Y, TDIGDYPERH	y tdigdyperh
SB, VPFDHGJ	sb vpfdhgj
KN, HHYTU	kn hhytu
XS, YC	xs yc
QX, EQ	qx eq
WS, IRZN	ws irzn
WF, HZ	wf hz
KCJ, IBG	kcj ibg
O, ZZGRT	o zzgrt
HBBO, JAQWJ	hbbo jaqwj
L, X	l x
TRT, WN	trt wn
LWTH, M	lwth m
JGPOL, WJ	jgpol wj
JLZVUX, A	jlzvux a
RFEZ, DJSW	rfez djsw
IB, YR	ib yr
ZLTB, X	zltb x
CG, RDKEN	cg rdken
P, YO	p yo
A, X	a x
TA, R	ta r
KNWXN, KA	knwxn ka
MUZ, YS	muz ys
U, MS	u ms
TU, LXNF	tu lxnf
O, S	o s
IRA, GGXS	ira ggxs
WLGT, B	wlgt b
T, TW	t tw
LLCS, I	llcs i
BWE, V	bwe v
I, RB	i rb
O, MM	o mm
F, SRCACYS	f srcacys
X, V	x v
TY, FT	ty ft
C, D	c d
INVLE, R	invle r
J, XZ	j xz
BGAAQ, WX	bgaaq wx
NAVTX, T	navtx t
H, GSO	h gso
GX, Y	gx y
SI, WMNX	si wmnx
GU, WNXUJ	gu wnxuj
S, X	s x
EDSM, F	edsm f
D, CHPRL	d chprl
BAYZMMG, Z	bayzmmg z
ONT, AJGZO	ont ajgzo
SUU, XP	suu xp
FM, X	fm x
YK, YZ	yk yz
UY, AG	uy ag
U, VFCYFDKH	u vfcyfdkh
UIDJ, ETUZX	uidj etuzx
T, CHG	t chg
CKCD, P	ckcd p
JE, HNBVE	je hnbve
G, LP	g lp
IWNCVOW, UE	iwncvow ue
E, T	e t
FP, M	fp m
UC, FJ	uc fj
UYN, XXD	uyn xxd
TQ, R	tq r
S, LW	s lw
VU, HK	vu hk
CSKPVAJI, KHH	cskpvaji khh
NP, XUZOSYUB	np xuzosyub
U, ZYH	u zyh
OB, V	ob v
AP, Q	ap q
J, A	j a
CLPK, KOG	clpk kog
X, VU	x vu
EQJD, V	eqjd v
WAOE, VI	waoe vi
UJ, ZOYBASDD	uj zoybasdd
TYN, KRY	tyn kry
DWIWZNV, K	dwiwznv k
PBPCDS, EE	pbpcds ee
JWIICP, U	jwiicp u
TCDL, E	tcdl e
QEI, XNLZZ	qei xnlzz
MY, ZCSO	my zcso
F, W	f w
V, WT	v wt
M, QANPJJHNDU	m qanpjjhndu
R, XG	r xg
SSIM, ORN	ssim orn
XO, MZ	xo mz
ANUVKU, C	anuvku c
P, HLR	p hlr
FB, GL	fb gl
VSGWFY, P	vsgwfy p
U, WWD	u wwd
U, M	u m
ZA, DF	za df
ZL, QSKESP	zl qskesp
Z, YIM	z yim
T, QZ	t qz
I, TB	i tb
YL, CNZTKK	yl cnztkk
D, M	d m
CJ, F	cj f
CZ, XIA	cz xia
VF, M	vf m
VGQ, K	vgq k
EZ, CEBC	ez cebc
CGLX, UG	cglx ug
C, K	c k
B, QNQ	b qnq
OK, XTD	ok xtd
BO, YHKB	bo yhkb
RN, W	rn w
S, Z	s z
E, UBK	e ubk
I, RT	i rt
XUXSD, RO	xuxsd ro
O, N	o n
UGRJU, Z	ugrju z
GEPHHV, P	gephhv p
E, ZTH	e zth
HMNH, HLG	hmnh hlg
Y, D	y d
IL, L	il l
UI, JKSOUZM	ui jksouzm
NQZTJ, CTO	nqztj cto
F, UJ	f uj
FO, VIY	fo viy
UHV, IMYY	uhv imyy
Y, V	y v
N, E	n e
CJPN, KHJ	cjpn khj
OBQHS, XAFE	obqhs xafe
H, EWU	h ewu
S, K	s k
FV, GU	fv gu
EC, UBBTAJJ	ec ubbtajj
LKVICHFM, TH	lkvichfm th
TJ, V	tj v
HN, X	hn x
ZFX, BNV	zfx bnv
WI, WW	wi ww
S, F	s f
IUUQ, N	iuuq n
I, DLI	i dli
CHDO, EV	chdo ev
LSUXSY, IBCG	lsuxsy ibcg
JIJ, BEA	jij bea
J, Y	j y
TZ, M	tz m
DA, A	da a
ER, IR	er ir
G, KD	g kd
CN, C	cn c
LO, HU	lo hu
Q, I	q i
I, QJ	i qj
S, VL	s vl
D, OCUXIMOROKHHV	d ocuximorokhhv
HT, VZEVQIFAYP	ht vzevqifayp
H, LNZK	h lnzk
L, SFP	l sfp
Q, H	q h
T, YCFVLLCQ	t ycfvllcq
G, YONJ	g yonj
LCDGLCIL, BHBJ	lcdglcil bhbj
R, AMK	r amk
Q, U	q u
O, VYIAIH	o vyiaih
RY, E	ry e
E, NL	e nl
YRRRUJH, W	yrrrujh w
Q, C	q c
OND, GTXSJEXBZH	ond gtxsjexbzh
HKPW, XLM	hkpw xlm
VIR, D	vir d
ZIYNBHM, PD	ziynbhm pd
G, RVHOP	g rvhop
RA, Q	ra q
DS, O	ds o
K, D	k d
P, QUU	p quu
F, TM	f tm
XPV, E	xpv e
PKK, Y	pkk y
V, M	v m
I, GYZRH	i gyzrh
L, OUDBDTUWA	l oudbdtuwa
LI, GTE	li gte
LZB, ZSPDU	lzb zspdu
HU, P	hu p
DDM, POG	ddm pog
Z, F	z f
SD, YAD	sd yad
O, PB	o pb
RWBWS, F	rwbws f
GRC, JOKE	grc joke
V, WXF	v wxf
S, R	s r
YW, LGE	yw lge
OH, KFL	oh kfl
IA, JA	ia ja
D, UBDX	d ubdx
PPF, G	ppf g
SZ, OKT	sz okt
VRBUSR, LMIPZNY	vrbusr lmipzny
L, DF	l df
V, KCM	v kcm
SCUDQ, M	scudq m
COIN, T	coin t
T, T	t t
Q, Y	q y
BJ, HQWRJOIT	bj hqwrjoit
D, LUAI	d luai
Q, Y	q y
Q, V	q v
O, UX	o ux
HY, P	hy p
HGUG, OG	hgug og
LJS, B	ljs b
M, U	m u
AIJL, V	aijl v
SJVWTGZOJ, VH	sjvwtgzoj vh
CGS, T	cgs t
PSR, QWEBC	psr qwebc
MKCIW, URKA	mkciw urka
SUQN, BO	suqn bo
U, KQHYYI	u kqhyyi
U, EV	u ev
N, EDGO	n edgo
BJ, CJU	bj cju
R, PB	r pb
Q, Z	q z
BDHT, P	bdht p
FW, XH	fw xh
R, VRNHY	r vrnhy
CGZ, XG	cgz xg
O, CGK	o cgk
VD, KB	vd kb
M, MKOGL	m mkogl
G, GB	g gb
NJLD, PKWH	njld pkwh
A, RM	a rm
RFQ, F	rfq f
RFNABT, VQSNHRWVFH	rfnabt vqsnhrwvfh
IT, IX	it ix
HVRX, Z	hvrx z
V, MIG	v mig
C, DXN	c dxn
V, DGGXZSX	v dggxzsx
AU, F	au f
XXPABUGZU, IQOWMA	xxpabugzu iqowma
GFE, CK	gfe ck
O, VRV	o vrv
LPK, UX	lpk ux
OL, QXRT	ol qxrt
CN, B	cn b
AWS, Y	aws y
H, R	h r
IL, A	il a
QGZ, YF	qgz yf
J, IR	j ir
XA, XOP	xa xop
JX, VXBB	jx vxbb
OIFBUY, ZZ	oifbuy zz
MXQ, SN	mxq sn
D, LAM	d lam
Q, TD	q td
C, G	c g
ZQ, ENZH	zq enzh
WT, X	wt x
VPY, CKTO	vpy ckto
W, EH	w eh
RFEHJ, OEMJHPUGA	rfehj oemjhpuga
IVDE, TGFX	ivde tgfx
B, UJ	b uj
IL, X	il x
VCMMHROPKT, CJ	vcmmhropkt cj
BSG, ZSUWBJ	bsg zsuwbj
U, ZTL	u ztl
C, ZDV	c zdv
FIS, N	fis n
DRC, WSYXDT	drc wsyxdt
VRIMTGPOGF, K	vrimtgpogf k
TF, XRBPNXP	tf xrbpnxp
HIJHKW, WFN	hijhkw wfn
BNQ, Q	bnq q
KJDYF, PI	kjdyf pi
P, DK	p dk
F, R	f r
B, O	b o
ND, CIC	nd cic
UAZ, Z	uaz z
B, HZ	b hz
LGKXQ, HQZ	lgkxq hqz
GO, G	go g
DJ, B	dj b
FAVSQ, WGYN	favsq wgyn
CH, NNIBOXJ	ch nniboxj
ROL, AF	rol af
U, P	u p
TY, R	ty r
VIH, UYRF	vih uyrf
T, CCN	t ccn
X, K	x k
GV, K	gv k
AC, RXG	ac rxg
ZYW, MH	zyw mh
BSTJK, H	bstjk h
LDTB, LB	ldtb lb
M, DI	m di
Y, JI	y ji
Q, U	q u
E, RD	e rd
LKZKNTSRAZJT, H	lkzkntsrazjt h
YDM, ILI	ydm ili
RKH, TOP	rkh top
OGK, FT	ogk ft
M, TL	m tl
QBOAAWKU, V	qboaawku v
R, J	r j
E, G	e g
DJK, Q	djk q
KOQV, D	koqv d
M, YMXM	m ymxm
XVVIDR, TIFCGHSN	xvvidr tifcghsn
PJ, SGP	pj sgp
P, WNJN	p wnjn
JGJ, IKYXWCDJE	jgj ikyxwcdje
FJ, I	fj i
GH, YH	gh yh
OVNR, I	ovnr i
LJ, D	lj d
S, K	s k
JD, Q	jd q
RQK, YFHOKNBI	rqk yfhoknbi
UIA, D	uia d
M, ID	m id
CKG, C	ckg c
VZ, O	vz o
OM, ESPNF	om espnf
KTV, H	ktv h
WBDW, MQF	wbdw mqf
CD, SR	cd sr
E, LRHLB	e lrhlb
DU, E	du e
JYXJEMGP, GU	jyxjemgp gu
OV, Q	ov q
M, ZQC	m zqc
LMCCWU, L	lmccwu l
RN, J	rn j
KPN, FV	kpn fv
K, PJY	k pjy
X, I	x i
D, LE	d le
OE, W	oe w
Y, PKJ	y pkj
S, N	s n
M, PBMOKO	m pbmoko
I, J	i j
EGG, H	egg h
RBD, ZD	rbd zd
O, Y	o y
K, HVB	k hvb
XGZ, PW	xgz pw
N, VZFG	n vzfg
C, VR	c vr
OFMF, IPHX	ofmf iphx
JP, QJL	jp qjl
FE, APDUUH	fe apduuh
B, VOVVPOUD	b vovvpoud
S, FBR	s fbr
DHKUOICL, FX	dhkuoicl fx
J, ON	j on
M, Y	m y
GUWYT, DJNXDFH	guwyt djnxdfh
G, DJHW	g djhw
FZ, S	fz s
SZOX, UUF	szox uuf
KQ, NPTBLD	kq nptbld
T, EVZ	t evz
N, VA	n va
BSVN, QXOP	bsvn qxop
ENJVN, S	enjvn s
FALC, OM	falc om
OA, K	oa k
FLZR, T	flzr t
AEXN, L	aexn l
PK, W	pk w
M, M	m m
H, Z	h z
R, MP	r mp
WLI, BKP	wli bkp
BF, QCF	bf qcf
G, FTKZZVZA	g ftkzzvza
E, SLO	e slo
K, DVBRCLHEM	k dvbrclhem
PJEOG, V	pjeog v
XX, I	xx i
Q, WKOEH	q wkoeh
BET, SV	bet sv
FEJX, D	fejx d
RYVA, A	ryva a
FFEL, MQ	ffel mq
C, P	c p
I, YD	i yd
FO, J	fo j
U, MAH	u mah
NZXR, U	nzxr u
HBRCMSIMDFH, S	hbrcmsimdfh s
S, MIJZ	s mijz
I, L	i l
Q, FEE	q fee
Y, WP	y wp
N, GWTCL	n gwtcl
NCF, LR	ncf lr
Q, GM	q gm
AN, DR	an dr
XEPWE, LK	xepwe lk
C, G	c g
EY, EG	ey eg
UAF, K	uaf k
MB, Z	mb z
PVRQ, HYW	pvrq hyw
EZTY, HMK	ezty hmk
H, XSCLX	h xsclx
CM, R	cm r
BS, GMV	bs gmv
EE, O	ee o
YF, RAIDP	yf raidp
KT, O	kt o
TY, NXI	ty nxi
KOQ, X	koq x
CC, K	cc k
PFLU, ZIWD	pflu ziwd
NR, YY	nr yy
LXJPAIG, YN	lxjpaig yn
MG, HMRSAB	mg hmrsab
V, KIQIO	v kiqio
HYCQEMJHMF, KSG	hycqemjhmf ksg
K, BI	k bi
OA, POF	oa pof
OCAL, UJ	ocal uj
L, D	l d
TIR, OV	tir ov
JG, M	jg m
PWJV, D	pwjv d
UUXEP, J	uuxep j
Y, LSC	y lsc
H, QB	h qb
N, I	n i
AANH, QP	aanh qp
PYX, R	pyx r
FQY, GNPS	fqy gnps
OR, NAWRK	or nawrk
S, P	s p
VA, CGRXFN	va cgrxfn
B, H	b h
TXZHWGZCQIV, EYP	txzhwgzcqiv eyp
R, Y	r y
FJ, EBWS	fj ebws
TX, H	tx h
J, I	j i
VBHIJKX, M	vbhijkx m
GEBXJ, EF	gebxj ef
JCR, S	jcr s
HI, ET	hi et
M, K	m k
P, ZSP	p zsp
M, QN	m qn
C, K	c k
SIUCLXPS, BQNFWMQYZO	siuclxps bqnfwmqyzo
RXJ, WKG	rxj wkg
X, NKRVZZ	x nkrvzz
NGK, TLZ	ngk tlz
EY, XSNSZXK	ey xsnszxk
MEWTL, KHEPO	mewtl khepo
RYJWJ, DQG	ryjwj dqg
NWO, ED	nwo ed
K, TMPSKN	k tmpskn
JSQBP, H	jsqbp h
O, HDN	o hdn
Z, AXO	z axo
DBHDX, OXKB	dbhdx oxkb
ILO, XYLK	ilo xylk
GGA, MWOODU	gga mwoodu
X, GVJ	x gvj
GA, KRK	ga krk
NXUYBV, NF	nxuybv nf
FRE, RN	fre rn
Z, U	z u
R, DF	r df
A, FWZ	a fwz
Z, MGGX	z mggx
C, S	c s
M, B	m b
QM, J	qm j
KB, ACKXU	kb ackxu
EW, DC	ew dc
NHW, Y	nhw y
DJN, F	djn f
V, DMAQ	v dmaq
XIM, VRYZ	xim vryz
UKDCSVH, F	ukdcsvh f
V, H	v h
R, MJMB	r mjmb
VU, VHPR	vu vhpr
VVDBLEA, J	vvdblea j
O, R	o r
V, ZV	v zv
WJSFBKRFUB, T	wjsfbkrfub t
U, NCGMBV	u ncgmbv
K, VCKO	k vcko
M, I	m i
B, BRRE	b brre
Z, Y	z y
BED, IQ	bed iq
HW, NZ	hw nz
WEYK, JYHP	weyk jyhp
EAJKG, A	eajkg a
RT, N	rt n
F, W	f w
MTKID, B	mtkid b
DFCNMWE, L	dfcnmwe l
G, F	g f
QXTMZ, RZ	qxtmz rz
I, GV	i gv
KYW, MY	kyw my
B, ZD	b zd
I, ZGSWZKPRKIMSY	i zgswzkprkimsy
T, M	t m
LAMRD, L	lamrd l
E, IHC	e ihc
R, S	r s
BVUCCNNF, ST	bvuccnnf st
X, Z	x z
S, J	s j
UFZCA, S	ufzca s
X, I	x i
FRD, MGR	frd mgr
FTSU, V	ftsu v
NM, LLYIZAPQDWHT	nm llyizapqdwht
A, JR	a jr
QYNXX, N	qynxx n
FC, J	fc j
NCJA, IJT	ncja ijt
W, A	w a
S, Z	s z
ZVA, CZA	zva cza
P, RQXC	p rqxc
FBU, PLQ	fbu plq
I, MNEC	i mnec
CXE, X	cxe x
QER, STIVUHQRYI	qer stivuhqryi
P, LWWEU	p lwweu
OBV, Z	obv z
ZR, LRLJPL	zr lrljpl
W, PI	w pi
HH, M	hh m
EZPKF, G	ezpkf g
W, XDJVAYWY	w xdjvaywy
E, EEB	e eeb
Y, Q	y q
HZM, HOKORJLKJD	hzm hokorjlkjd
VC, PAEZRC	vc paezrc
O, Z	o z
Y, G	y g
SYFZLIXRB, FV	syfzlixrb fv
ME, NZK	me nzk
U, IPY	u ipy
I, VF	i vf
P, XJX	p xjx
KW, M	kw m
HL, DY	hl dy
BIIH, B	biih b
KO, Z	ko z
TIL, YCY	til ycy
A, QXNDBT	a qxndbt
ZYN, R	zyn r
WV, J	wv j
ZTIDD, KYE	ztidd kye
QIB, BRR	qib brr
YCL, T	ycl t
B, VHVB	b vhvb
PFMTA, YTRKF	pfmta ytrkf
K, I	k i
OEXWZ, I	oexwz i
TPQ, E	tpq e
V, L	v l
V, X	v x
TY, JZF	ty jzf
CX, C	cx c
PNHMFFD, ODN	pnhmffd odn
E, K	e k
AA, G	aa g
GHSI, Y	ghsi y
UONN, J	uonn j
BJ, Q	bj q
I, GP	i gp
NXU, G	nxu g
IKSZ, J	iksz j
U, N	u n
TEVQJSA, AVOK	tevqjsa avok
WU, E	wu e
A, MLQL	a mlql
X, Q	x q
XBT, XJV	xbt xjv
U, R	u r
QTD, G	qtd g
G, SAB	g sab
UQK, Y	uqk y
EITV, OW	eitv ow
XO, US	xo us
J, AJA	j aja
F, EG	f eg
UAPYJVSK, K	uapyjvsk k
MVHX, VUUM	mvhx vuum
Z, V	z v
YC, M	yc m
JP, Q	jp q
S, PRDVDG	s prdvdg
SMT, HN	smt hn
WABC, Y	wabc y
E, K	e k
K, Z	k z
LI, ZE	li ze
P, SQBD	p sqbd
EIPQE, OTYEQJI	eipqe otyeqji
Y, FC	y fc
OXRBK, KLLRK	oxrbk kllrk
P, TD	p td
GO, PFO	go pfo
MP, TUO	mp tuo
A, CP	a cp
KC, S	kc s
H, Y	h y
HOAHR, FJYU	hoahr fjyu
TIWQLEL, KJPZP	tiwqlel kjpzp
A, U	a u
WWD, LLK	wwd llk
WX, T	wx t
BGQU, VW	bgqu vw
U, GIA	u gia
TCK, O	tck o
V, O	v o
BCZZF, TWWYCPP	bczzf twwycpp
WP, MO	wp mo
WDGC, BR	wdgc br
K, U	k u
Q, DY	q dy
U, Z	u z
X, V	x v
YPH, C	yph c
PMXTB, P	pmxtb p
WD, EE	wd ee
T, VYERM	t vyerm
XCYEQ, GJUMSSVR	xcyeq gjumssvr
V, ML	v ml
V, DC	v dc
W, Q	w q
SGDM, BM	sgdm bm
UG, EY	ug ey
I, WHSS	i whss
E, GRJC	e grjc
PN, Z	pn z
OB, S	ob s
GSKU, OU	gsku ou
HPL, BFQ	hpl bfq
H, G	h g
IB, LNZBRAV	ib lnzbrav
GBTVOP, JV	gbtvop jv
R, L	r l
QX, C	qx c
OEU, VCNFAKRNZL	oeu vcnfakrnzl
N, GV	n gv
M, Q	m q
SPROWO, E	sprowo e
Q, Q	q q
I, JYJLEJLGDB	i jyjlejlgdb
PILJCSIK, DSTB	piljcsik dstb
F, Y	f y
V, QW	v qw
XK, CQ	xk cq
E, SCHYEWVB	e schyewvb
IP, MHLL	ip mhll
E, I	e i
X, F	x f
I, E	i e
C, ZYG	c zyg
ZQCBXG, EIKIJ	zqcbxg eikij
O, H	o h
K, J	k j
C, GAZ	c gaz
G, XX	g xx
OKI, TFAHTETG	oki tfahtetg
Q, N	q n
GHNB, LJ	ghnb lj
SLSZFT, EU	slszft eu
UJDNVCTFH, V	ujdnvctfh v
DN, BS	dn bs
AB, T	ab t
YE, HYM	ye hym
HXMGA, PE	hxmga pe
MC, T	mc t
FO, LK	fo lk
T, CFD	t cfd
BFB, R	bfb r
L, G	l g
OTC, J	otc j
XCK, M	xck m
TR, TNX	tr tnx
FK, BC	fk bc
P, LU	p lu
B, C	b c
LY, DTH	ly dth
XGIX, EWU	xgix ewu
OEMZU, TK	oemzu tk
RN, LV	rn lv
JJQB, CYRZTZ	jjqb cyrztz
R, F	r f
P, XFQ	p xfq
UX, ZBVB	ux zbvb
D, H	d h
L, D	l d
JR, LY	jr ly
YFZ, IL	yfz il
MCEXMMGJO, U	mcexmmgjo u
AN, H	an h
P, NKKTTVS	p nkkttvs
Q, SNC	q snc
H, YQKSI	h yqksi
O, BU	o bu
RA, VO	ra vo
WV, A	wv a
Y, GBDU	y gbdu
CN, E	cn e
V, UFDBT	v ufdbt
O, DOQ	o doq
DFEHAWOR, SA	dfehawor sa
T, L	t l
HVW, SXKKQH	hvw sxkkqh
P, W	p w
SPZ, O	spz o
S, BRM	s brm
VJBZ, DX	vjbz dx
JJG, MT	jjg mt
ELSJOKRCGE, A	elsjokrcge a
Y, ZI	y zi
AWGVI, HFR	awgvi hfr
HS, BWEBQ	hs bwebq
J, ULL	j ull
B, MX	b mx
E, Z	e z
EM, C	em c
BJ, EPW	bj epw
WZRVR, H	wzrvr h
S, WUKR	s wukr
IKN, L	ikn l
V, UATQ	v uatq
GOPJ, SP	gopj sp
KF, FOPN	kf fopn
R, EYL	r eyl
NZEZY, FU	nzezy fu
O, A	o a
C, R	c r
MJCFF, KDG	mjcff kdg
JVAQ, QEZNTF	jvaq qezntf
A, J	a j
O, IXVP	o ixvp
C, GMENKIFLLNP	c gmenkifllnp
ZX, DMWYXOC	zx dmwyxoc
H, Y	h y
I, DZZ	i dzz
HB, F	hb f
SL, IHEIK	sl iheik
V, A	v a
ZUM, F	zum f
E, F	e f
CVO, IBCA	cvo ibca
K, P	k p
I, FMLL	i fmll
J, AJ	j aj
MA, UCCN	ma uccn
LA, X	la x
KWA, YQU	kwa yqu
NPC, XCADJYL	npc xcadjyl
PYJ, F	pyj f
CUB, G	cub g
VC, ZU	vc zu
CSJ, K	csj k
O, XMQ	o xmq
M, WJ	m wj
S, AZ	s az
CQG, Q	cqg q
RZKOAH, W	rzkoah w
UU, J	uu j
L, CLDO	l cldo
Z, FV	z fv
MG, SQW	mg sqw
OYVWHAFGO, HQ	oyvwhafgo hq
N, SNY	n sny
NJC, JWL	njc jwl
SH, QM	sh qm
THA, Y	tha y
PMH, A	pmh a
MHS, W	mhs w
YDWTQE, FDB	ydwtqe fdb
PLO, V	plo v
ANVGS, LGZRAB	anvgs lgzrab
ADT, UEQ	adt ueq
WPIMY, BJIJ	wpimy bjij
U, JVKAHU	u jvkahu
C, ML	c ml
ZJNR, P	zjnr p
XS, Y	xs y
YMA, H	yma h
OR, MN	or mn
QS, HCXRUGXMDGXB	qs hcxrugxmdgxb
B, SJJD	b sjjd
U, RUY	u ruy
BZD, YDDXGTRQ	bzd yddxgtrq
FT, INIGVV	ft inigvv
E, Y	e y
CYDZ, RO	cydz ro
G, UAWF	g uawf
AB, FFQJAV	ab ffqjav
FRKVDLG, FNZY	frkvdlg fnzy
LTLC, J	ltlc j
HF, ZCZIR	hf zczir
OQM, OWAGJR	oqm owagjr
OZ, ON	oz on
SM, UBAOX	sm ubaox
V, WTMHPKE	v wtmhpke
WYQ, EISUN	wyq eisun
AO, PO	ao po
ZP, F	zp f
ULF, ELUHDT	ulf eluhdt
N, PC	n pc
C, I	c i
GZFOMX, K	gzfomx k
H, J	h j
CKCZB, V	ckczb v
O, KR	o kr
R, CTF	r ctf
HK, AEV	hk aev
CQ, MQKXHPSEG	cq mqkxhpseg
M, M	m m
X, H	x h
FN, U	fn u
YCVXY, R	ycvxy r
Z, IUFUF	z iufuf
IX, F	ix f
AC, TQ	ac tq
RPN, WKH	rpn wkh
CA, ODGN	ca odgn
GFYDTTVDOW, LO	gfydttvdow lo
A, T	a t
DS, IG	ds ig
V, F	v f
O, Y	o y
Y, LYS	y lys
ZT, BCR	zt bcr
P, T	p t
F, O	f o
QUWOGSZT, YJND	quwogszt yjnd
RVVFRX, LSBJL	rvvfrx lsbjl
HUHQX, RKAAE	huhqx rkaae
GXH, JO	gxh jo
ZTLDVEIS, Z	ztldveis z
N, AFV	n afv
N, V	n v
S, VU	s vu
LDHPJT, HTWQU	ldhpjt htwqu
C, AQPI	c aqpi
YWC, K	ywc k
C, PINHOQU	c pinhoqu
Q, DVJB	q dvjb
DE, B	de b
IH, ZSU	ih zsu
KKCNJM, I	kkcnjm i
G, UR	g ur
T, H	t h
L, UKG	l ukg
VB, C	vb c
S, ZUADBG	s zuadbg
V, R	v r
O, YOX	o yox
PJH, RFQ	pjh rfq
Q, MN	q mn
JEEZVE, N	jeezve n
L, G	l g
MA, W	ma w
TE, C	te c
VMF, RJ	vmf rj
CZANE, YH	czane yh
O, G	o g
E, J	e j
Q, QZ	q qz
B, OCXGG	b ocxgg
OJZBBQQZO, FI	ojzbbqqzo fi
Z, C	z c
DXMA, RTLNN	dxma rtlnn
YO, JKXF	yo jkxf
LM, C	lm c
N, H	n h
C, V	c v
KSYA, JZZE	ksya jzze
Y, BJRPHOW	y bjrphow
Q, QULX	q qulx
A, VKCVQ	a vkcvq
AMLE, TNRHDT	amle tnrhdt
VZU, GKHFA	vzu gkhfa
B, KCN	b kcn
CW, O	cw o
ZYEN, SLB	zyen slb
VIKEBM, XR	vikebm xr
ESNP, R	esnp r
TFYTY, BZY	tfyty bzy
YMCM, J	ymcm j
I, O	i o
KH, VAOB	kh vaob
R, V	r v
AQYSRQNYGY, KQ	aqysrqnygy kq
DTZO, KZAEQ	dtzo kzaeq
T, DHCJ	t dhcj
V, TFU	v tfu
M, H	m h
GNXRHCRRPECFSJQXYIQJ, ZQQM	gnxrhcrrpecfsjqxyiqj zqqm
B, ELOBRO	b elobro
NZ, ROJL	nz rojl
JEL, SKAM	jel skam
GN, B	gn b
RYG, J	ryg j
F, R	f r
PZWE, XATM	pzwe xatm
OP, U	op u
BDVRKFCS, VQWS	bdvrkfcs vqws
YVK, FZRBG	yvk fzrbg
GGG, K	ggg k
O, LO	o lo
RU, CGCT	ru cgct
YST, W	yst w
UZGH, ATO	uzgh ato
G, SBY	g sby
C, UNNLDW	c unnldw
SWKYLMWT, QHR	swkylmwt qhr
VD, B	vd b
OWSIV, FC	owsiv fc
YNHTFP, L	ynhtfp l
T, C	t c
XM, OCA	xm oca
A, C	a c
CVWBX, NB	cvwbx nb
U, U	u u
B, D	b d
MK, DSVG	mk dsvg
ZB, D	zb d
J, G	j g
V, Q	v q
G, F	g f
O, QR	o qr
ZT, TN	zt tn
IMU, YIVK	imu yivk
W, I	w i
IHZ, PUKN	ihz pukn
O, U	o u
TDDH, NV	tddh nv
QB, E	qb e
SXXUJOZH, NOO	sxxujozh noo
PSP, DUKUC	psp dukuc
V, PK	v pk
DM, NA	dm na
E, RPJZ	e rpjz
P, J	p j
N, DJFX	n djfx
ZB, S	zb s
QSDXE, H	qsdxe h
CW, C	cw c
BM, U	bm u
Z, TO	z to
OQ, K	oq k
PG, QZVNDRKLKZH	pg qzvndrklkzh
M, C	m c
V, QV	v qv
H, NKFBJSRH	h nkfbjsrh
H, IG	h ig
RVFC, JZY	rvfc jzy
KF, N	kf n
M, OX	m ox
FC, JBE	fc jbe
FIUMB, DU	fiumb du
GI, ON	gi on
X, WFGR	x wfgr
VR, IR	vr ir
SR, GGOYEPZ	sr ggoyepz
FLO, U	flo u
A, N	a n
LKX, LHLRT	lkx lhlrt
W, B	w b
ZYA, DBI	zya dbi
MUDTA, BTL	mudta btl
AEX, F	aex f
VMCW, T	vmcw t
W, T	w t
S, OPRBX	s oprbx
P, R	p r
K, LWCN	k lwcn
US, F	us f
MJ, BV	mj bv
NA, KES	na kes
XURU, Z	xuru z
G, WVIS	g wvis
NY, SO	ny so
BZG, MR	bzg mr
A, V	a v
GP, C	gp c
PNR, HUJ	pnr huj
AXAA, OX	axaa ox
PC, MNCQ	pc mncq
X, E	x e
F, V	f v
JHX, B	jhx b
B, IF	b if
D, A	d a
LQ, XS	lq xs
EE, VLSJJT	ee vlsjjt
E, N	e n
ZUDSS, VMM	zudss vmm
S, P	s p
GVGQS, Y	gvgqs y
WSI, JU	wsi ju
PH, HCIYXO	ph hciyxo
FS, X	fs x
J, WWRBZX	j wwrbzx
CO, W	co w
CWGV, HLPIHIZBJ	cwgv hlpihizbj
GX, G	gx g
FODSBXR, U	fodsbxr u
OH, EL	oh el
P, AQ	p aq
VTFVX, DB	vtfvx db
XTHSABX, QXZB	xthsabx qxzb
WM, Z	wm z
SIYBUJ, L	siybuj l
OTI, DMH	oti dmh
ZDX, LYXWEX	zdx lyxwex
YIO, WXSZ	yio wxsz
LOCL, O	locl o
LE, Q	le q
DHF, MD	dhf md
OEGSJB, JD	oegsjb jd
MD, UF	md uf
O, MV	o mv
OMH, L	omh l
UCKRA, K	uckra k
HE, Y	he y
K, F	k f
IN, U	in u
T, E	t e
VT, NOTUOJ	vt notuoj
OCM, OH	ocm oh
Y, XY	y xy
YLOFYF, L	ylofyf l
XGMN, I	xgmn i
Z, V	z v
VJ, RS	vj rs
RVNAQ, S	rvnaq s
K, L	k l
KBYKN, DUWFG	kbykn duwfg
QG, E	qg e
YLOA, BVUM	yloa bvum
F, JXU	f jxu
IN, Z	in z
Z, DL	z dl
O, TJK	o tjk
FPZ, E	fpz e
M, X	m x
YL, WEETP	yl weetp
FZC, HT	fzc ht
I, ZJA	i zja
GN, L	gn l
Q, SA	q sa
HDI, HZ	hdi hz
Y, SH	y sh
NRGQMMZW, LTU	nrgqmmzw ltu
SOR, MKQO	sor mkqo
OD, ZBOBXKFSGP	od zbobxkfsgp
EGF, B	egf b
L, BZBZIKJZPE	l bzbzikjzpe
I, RSEIYQ	i rseiyq
WBC, TV	wbc tv
H, M	h m
OS, K	os k
I, LY	i ly
N, TUMD	n tumd
SFPRG, UWZ	sfprg uwz
TU, K	tu k
BQJ, NVJQO	bqj nvjqo
U, X	u x
T, KYECHCA	t kyechca
D, FY	d fy
IOZ, AGA	ioz aga
L, LYHRENMYG	l lyhrenmyg
RPGPTDYH, O	rpgptdyh o
M, S	m s
WUM, QG	wum qg
C, O	c o
V, NTYW	v ntyw
NTC, JUZ	ntc juz
VQHRL, HG	vqhrl hg
TG, EL	tg el
L, NRSRCL	l nrsrcl
W, Y	w y
OCR, FCG	ocr fcg
AU, TO	au to
DTCHST, BKWJL	dtchst bkwjl
K, UC	k uc
JESL, J	jesl j
F, M	f m
R, JY	r jy
EMX, I	emx i
WHSA, W	whsa w
U, HEAK	u heak
J, DLE	j dle
PHDKX, XURA	phdkx xura
CFVMOF, ZD	cfvmof zd
WL, J	wl j
O, LZ	o lz
B, V	b v
BI, FY	bi fy
L, T	l t
N, GLD	n gld
JV, D	jv d
N, LUL	n lul
AH, K	ah k
BSFT, Z	bsft z
H, N	h n
LY, EV	ly ev
AB, CA	ab ca
M, E	m e
TB, QLDTXKL	tb qldtxkl
W, D	w d
CQ, YQ	cq yq
H, PS	h ps
OB, U	ob u
R, K	r k
BVZ, UTJF	bvz utjf
DQ, LL	dq ll
N, X	n x
SX, J	sx j
QPO, RC	qpo rc
G, D	g d
O, K	o k
YHW, RRO	yhw rro
EUO, EP	euo ep
D, B	d b
J, P	j p
J, WGTB	j wgtb
HBSW, YWR	hbsw ywr
T, JKLR	t jklr
PG, I	pg i
O, ID	o id
W, N	w n
GZ, J	gz j
EMF, P	emf p
KG, Y	kg y
K, BPPQBPO	k bppqbpo
Q, AK	q ak
MM, BEB	mm beb
WB, K	wb k
Q, ZI	q zi
ZDVFR, YXEARR	zdvfr yxearr
OGE, ZFWDW	oge zfwdw
J, SG	j sg
ZIN, Z	zin z
TX, OSYM	tx osym
OAO, KL	oao kl
ZCHA, A	zcha a
D, V	d v
Q, AC	q ac
D, S	d s
LJKQA, H	ljkqa h
U, SOAZRZRL	u soazrzrl
B, C	b c
HYABZ, YNGC	hyabz yngc
HF, UIZ	hf uiz
V, I	v i
X, WE	x we
B, R	b r
Z, X	z x
TVR, MRVC	tvr mrvc
SVIYYGMQT, IVSH	sviyygmqt ivsh
QIL, QL	qil ql
U, YBW	u ybw
ZZE, PG	zze pg
L, X	l x
N, GF	n gf
FUNC, IV	func iv
U, E	u e
NKH, BO	nkh bo
O, CBE	o cbe
IW, EJ	iw ej
CR, FF	cr ff
A, I	a i
Y, V	y v
RGHWN, TNP	rghwn tnp
Y, L	y l
WIN, L	win l
C, IMLIAX	c imliax
DUEI, L	duei l
R, W	r w
KQU, GDODSP	kqu gdodsp
I, UVI	i uvi
WXBOLK, BF	wxbolk bf
KHSI, N	khsi n
P, FO	p fo
NOLKUO, G	nolkuo g
LCO, DRCG	lco drcg
SNCC, WM	sncc wm
GM, GC	gm gc
TK, BOAICFYT	tk boaicfyt
NT, RBNCJ	nt rbncj
T, WY	t wy
HMKMDK, GFWR	hmkmdk gfwr
HB, ZSQ	hb zsq
OEL, J	oel j
Y, E	y e
T, LHT	t lht
P, V	p v
A, Z	a z
ZU, V	zu v
BH, O	bh o
IZJEEUH, BG	izjeeuh bg
WDB, Y	wdb y
LAT, GX	lat gx
Q, B	q b
QI, HDXAFGLW	qi hdxafglw
S, W	s w
XJ, OB	xj ob
ZWHFJVFMJAS, X	zwhfjvfmjas x
TJCXE, TDLNLHX	tjcxe tdlnlhx
L, P	l p
F, T	f t
E, DG	e dg
XJ, E	xj e
R, FQXO	r fqxo
Y, W	y w
N, Z	n z
R, D	r d
N, T	n t
SHEMUETHCB, MO	shemuethcb mo
BZXF, P	bzxf p
M, AWSPPY	m awsppy
UTNFQP, N	utnfqp n
YDA, Q	yda q
GR, HU	gr hu
F, O	f o
M, O	m o
YK, NQYS	yk nqys
T, C	t c
TU, L	tu l
ZZUZ, LCK	zzuz lck
K, S	k s
YOA, J	yoa j
R, BM	r bm
U, QA	u qa
OC, T	oc t
K, NY	k ny
W, BY	w by
WS, QQZWFRFZI	ws qqzwfrfzi
F, NQW	f nqw
M, LXI	m lxi
Z, L	z l
CSV, G	csv g
OWCM, GHK	owcm ghk
OSKWOJWIJHZUJGF, EYBF	oskwojwijhzujgf eybf
B, H	b h
Q, RMMC	q rmmc
HH, GJUI	hh gjui
P, U	p u
M, KAV	m kav
P, VPMT	p vpmt
OLL, DJKU	oll djku
V, G	v g
G, VQHXU	g vqhxu
WELHMQR, NX	welhmqr nx
WR, A	wr a
T, BK	t bk
D, U	d u
MX, YOGHK	mx yoghk
O, VEE	o vee
OG, JP	og jp
L, WR	l wr
RAZ, VQBAFGZ	raz vqbafgz
X, MAF	x maf
Z, U	z u
NDPFPT, TBXAOCJJ	ndpfpt tbxaocjj
BIB, VJ	bib vj
HLE, U	hle u
CWZDRQ, Y	cwzdrq y
QN, SKTDYY	qn sktdyy
OWR, QMQO	owr qmqo
A, DHKRQV	a dhkrqv
E, H	e h
QN, HBPPBJYO	qn hbppbjyo
N, W	n w
K, GN	k gn
N, TS	n ts
L, QB	l qb
AGDT, SH	agdt sh
V, UPAS	v upas
GP, Y	gp y
W, Q	w q
ONGX, DGG	ongx dgg
A, N	a n
G, D	g d
B, IR	b ir
K, DZ	k dz
ZF, H	zf h
U, Z	u z
AS, U	as u
F, W	f w
SUQ, L	suq l
XKO, V	xko v
CVI, VX	cvi vx
PPE, XWD	ppe xwd
B, Q	b q
J, KZO	j kzo
C, MOD	c mod
K, CPB	k cpb
G, WK	g wk
V, KRCUAD	v krcuad
IB, UF	ib uf
QKN, Q	qkn q
STXUV, FP	stxuv fp
U, MC	u mc
HOH, B	hoh b
Y, OX	y ox
OJA, X	oja x
JD, V	jd v
K, P	k p
GIUEN, SY	giuen sy
N, C	n c
XARW, T	xarw t
GSO, TR	gso tr
DTO, ODG	dto odg
G, GF	g gf
SV, PCOHFP	sv pcohfp
KGV, SC	kgv sc
PGK, SDHVNA	pgk sdhvna
U, Q	u q
P, AAVGSX	p aavgsx
R, F	r f
S, Z	s z
V, F	v f
W, C	w c
ZEVYB, OQ	zevyb oq
DM, TWL	dm twl
A, PQYMH	a pqymh
EH, DE	eh de
P, W	p w
EXG, BAF	exg baf
CQ, JJU	cq jju
I, WD	i wd
JK, ZYXOQ	jk zyxoq
RZXRTXS, V	rzxrtxs v
I, CU	i cu
ZY, XEQVJFKHYK	zy xeqvjfkhyk
TR, CL	tr cl
T, S	t s
Y, Y	y y
BZVXO, JYGDRG	bzvxo jygdrg
SU, A	su a
KT, BWGCPFA	kt bwgcpfa
R, ZMG	r zmg
H, A	h a
KOC, LKCG	koc lkcg
B, G	b g
Z, D	z d
D, I	d i
HMTH, HSKLQ	hmth hsklq
OVPWLZ, KF	ovpwlz kf
MO, TY	mo ty
BP, RZYGF	bp rzygf
PA, IB	pa ib
Y, WCXWMZ	y wcxwmz
U, ZJ	u zj
CHNBO, J	chnbo j
T, JC	t jc
JBCSXT, NT	jbcsxt nt
OI, MPAVVNP	oi mpavvnp
C, MQY	c mqy
H, FZTK	h fztk
QO, RT	qo rt
R, RRASZ	r rrasz
JABTKGX, P	jabtkgx p
KX, ROQ	kx roq
DQ, G	dq g
EM, O	em o
JS, RU	js ru
W, O	w o
M, R	m r
XWJIQSAO, WA	xwjiqsao wa
AK, ZKDUWQ	ak zkduwq
X, AO	x ao
FPG, X	fpg x
M, GTL	m gtl
SLCQZ, SGJPBIP	slcqz sgjpbip
H, GZILWIFB	h gzilwifb
B, YNN	b ynn
V, ZSCBOU	v zscbou
X, T	x t
J, E	j e
GYJT, U	gyjt u
JT, UD	jt ud
M, JRKIEJ	m jrkiej
A, K	a k
H, LUG	h lug
BNPG, ANBGITVVKRZ	bnpg anbgitvvkrz
TTLIQ, K	ttliq k
JT, CGCTR	jt cgctr
IFM, ILZK	ifm ilzk
BNFF, LZ	bnff lz
ZMRXMZ, PWA	zmrxmz pwa
MN, URXBWBBEPAIHP	mn urxbwbbepaihp
O, T	o t
EWD, B	ewd b
FUQM, GTTE	fuqm gtte
FAA, YQRHYDAFJ	faa yqrhydafj
JSG, I	jsg i
R, H	r h
CIM, F	cim f
ZSOKC, F	zsokc f
ZWUH, AC	zwuh ac
L, XD	l xd
H, N	h n
N, YR	n yr
QQJZ, KKJJ	qqjz kkjj
TOC, KJ	toc kj
G, XX	g xx
ZEC, OBW	zec obw
XRFXI, M	xrfxi m
DX, RQUFL	dx rqufl
ECSDHYOKG, SY	ecsdhyokg sy
A, EO	a eo
P, UL	p ul
M, IJ	m ij
YQK, G	yqk g
H, FAHF	h fahf
DQ, GG	dq gg
LCU, J	lcu j
LK, Y	lk y
EWK, DVX	ewk dvx
SD, FTW	sd ftw
XPNW, Y	xpnw y
Z, AL	z al
V, TWO	v two
UPZZT, N	upzzt n
ZRESF, W	zresf w
RKFV, SPVFVDFZ	rkfv spvfvdfz
UG, D	ug d
ZNH, EBO	znh ebo
BY, GW	by gw
ZHZNHPVZZA, X	zhznhpvzza x
INQB, F	inqb f
QXI, D	qxi d
WVWA, UT	wvwa ut
I, JUI	i jui
YP, XCX	yp xcx
Y, AWVW	y awvw
SF, JXS	sf jxs
F, RH	f rh
R, C	r c
D, HQ	d hq
WM, OSABFJ	wm osabfj
BMEZX, VXR	bmezx vxr
F, A	f a
JC, VDQE	jc vdqe
VGMCYFA, GA	vgmcyfa ga
USYKV, ZVJJ	usykv zvjj
GXGP, CIDFNPPS	gxgp cidfnpps
C, CQWO	c cqwo
IMP, UZ	imp uz
U, YK	u yk
C, EDMNZG	c edmnzg
KX, Y	kx y
L, SE	l se
KEFZE, J	kefze j
BNRZ, EV	bnrz ev
DOJDE, MC	dojde mc
A, T	a t
OTS, ZT	ots zt
ME, INO	me ino
OFO, KN	ofo kn
V, CHPJUNB	v chpjunb
BD, UJLKOEWT	bd ujlkoewt
VXCZINOXA, H	vxczinoxa h
RM, TVJ	rm tvj
L, A	l a
DOVM, Z	dovm z
FLJ, WML	flj wml
ZCA, GCC	zca gcc
C, MS	c ms
VWWA, O	vwwa o
N, S	n s
LA, E	la e
UI, R	ui r
IB, U	ib u
GO, U	go u
YIA, TZ	yia tz
U, Q	u q
I, GE	i ge
TL, ACCLVGA	tl acclvga
D, BVGJJLBX	d bvgjjlbx
YX, TZZEN	yx tzzen
O, N	o n
UHHHNTO, PG	uhhhnto pg
J, I	j i
JVZGDBBJ, AH	jvzgdbbj ah
L, G	l g
E, PI	e pi
SATBUL, YKQ	satbul ykq
VAHT, P	vaht p
U, KJMXHGA	u kjmxhga
SM, FQD	sm fqd
J, W	j w
D, HF	d hf
YERFU, E	yerfu e
KJG, J	kjg j
EJ, XUX	ej xux
BRYL, D	bryl d
M, O	m o
AN, I	an i
U, ESYY	u esyy
MCQB, DP	mcqb dp
XOOW, CN	xoow cn
Q, HFKGBB	q hfkgbb
LS, U	ls u
DHTVDY, NSQ	dhtvdy nsq
OURR, VM	ourr vm
BN, VUF	bn vuf
DODRWJKEQ, IIMP	dodrwjkeq iimp
IM, Z	im z
SL, TABWID	sl tabwid
M, N	m n
IZ, HSAO	iz hsao
R, JC	r jc
XL, O	xl o
LVM, Q	lvm q
N, X	n x
X, QZKD	x qzkd
YGS, UV	ygs uv
LAFPGJUQ, YPNMGTBH	lafpgjuq ypnmgtbh
X, N	x n
Z, W	z w
VYY, G	vyy g
NZGOBS, V	nzgobs v
Q, Q	q q
Z, B	z b
FU, JTR	fu jtr
RBP, J	rbp j
VR, F	vr f
H, M	h m
DQI, PO	dqi po
AH, DDM	ah ddm
O, FH	o fh
RDVR, TBC	rdvr tbc
G, IC	g ic
AMOD, XG	amod xg
NBJ, QL	nbj ql
MKRE, TH	mkre th
TGALDW, WRRT	tgaldw wrrt
ZRANPQIXRVDX, S	zranpqixrvdx s
P, SY	p sy
ABFY, LB	abfy lb
ZOP, D	zop d
DH, I	dh i
P, DF	p df
S, F	s f
IS, XSAHA	is xsaha
GY, RG	gy rg
JA, DMGJ	ja dmgj
YL, CP	yl cp
LW, C	lw c
H, BN	h bn
WNFR, A	wnfr a
PQ, SQMYRDC	pq sqmyrdc
NAPPUVBPTWI, YUM	nappuvbptwi yum
B, TAEAFIAX	b taeafiax
LXB, VLBWZ	lxb vlbwz
DF, N	df n
N, DCESEVSG	n dcesevsg
GID, G	gid g
ND, E	nd e
J, AJ	j aj
HKVM, MZWIKZ	hkvm mzwikz
K, MZS	k mzs
Y, UY	y uy
RHI, T	rhi t
QCE, I	qce i
H, NL	h nl
I, RO	i ro
HLHZ, J	hlhz j
R, MBSDYHLS	r mbsdyhls
CH, Q	ch q
TTGHI, NM	ttghi nm
U, PQ	u pq
QGMLS, GJE	qgmls gje
TP, VGDDR	tp vgddr
R, E	r e
E, M	e m
CVZNM, QLN	cvznm qln
V, HG	v hg
PRY, VQWR	pry vqwr
YK, S	yk s
YWBBMOU, DA	ywbbmou da
X, D	x d
H, G	h g
MJG, CC	mjg cc
GD, AFCU	gd afcu
FIPJ, X	fipj x
UBFA, Z	ubfa z
GGZ, SS	ggz ss
K, HNA	k hna
O, DH	o dh
H, OK	h ok
ZY, J	zy j
N, V	n v
H, KJKLAY	h kjklay
R, AB	r ab
RKFX, E	rkfx e
HB, L	hb l
O, Q	o q
URU, H	uru h
DWEXV, FOJ	dwexv foj
ILW, V	ilw v
KG, NIM	kg nim
MUEOF, O	mueof o
TPRBN, L	tprbn l
DZAIVIDWH, I	dzaividwh i
NMS, PPMR	nms ppmr
U, BUGJ	u bugj
A, YO	a yo
OMM, BB	omm bb
N, N	n n
FNT, QF	fnt qf
I, IRGD	i irgd
A, AU	a au
WS, W	ws w
L, C	l c
XWMRO, BPA	xwmro bpa
POEXNPAC, UDBP	poexnpac udbp
R, D	r d
J, UQKT	j uqkt
DUSUCRW, MW	dusucrw mw
UQJFUV, MM	uqjfuv mm
LQS, EGX	lqs egx
X, GNW	x gnw
WF, N	wf n
MBG, YM	mbg ym
AFW, YFPY	afw yfpy
MJU, KT	mju kt
ACSEK, BV	acsek bv
E, S	e s
YLK, LGKKJN	ylk lgkkjn
K, WFP	k wfp
WNRORUM, XFU	wnrorum xfu
CLI, X	cli x
YR, DZ	yr dz
MDI, YL	mdi yl
VI, O	vi o
E, T	e t
TRXXC, E	trxxc e
S, FS	s fs
ZS, P	zs p
I, A	i a
V, I	v i
C, R	c r
AHABR, VTX	ahabr vtx
X, SD	x sd
R, DIC	r dic
JE, P	je p
Z, TEMUOP	z temuop
A, DUA	a dua
DZNEVVR, PB	dznevvr pb
Q, M	q m
VI, R	vi r
W, F	w f
M, TUUWS	m tuuws
J, LZ	j lz
GHGJQ, KA	ghgjq ka
XMA, WDQPV	xma wdqpv
G, KNJ	g knj
KXEI, O	kxei o
ORJAGB, RI	orjagb ri
TSE, Q	tse q
US, Z	us z
BCG, VFWN	bcg vfwn
AZMDVTTYZXI, XF	azmdvttyzxi xf
DHTYF, IZRQSVK	dhtyf izrqsvk
GSE, GU	gse gu
WO, M	wo m
BHROGNUJRR, H	bhrognujrr h
V, ZIWOY	v ziwoy
DVQ, SD	dvq sd
PHEOQGY, Y	pheoqgy y
Y, C	y c
C, S	c s
O, ZZ	o zz
LH, VF	lh vf
X, NL	x nl
HUSWC, FX	huswc fx
ZJL, M	zjl m
L, ZFP	l zfp
QBB, G	qbb g
NCLU, M	nclu m
K, R	k r
L, GBGNZXGR	l gbgnzxgr
K, XX	k xx
G, MY	g my
M, JG	m jg
KIR, ZC	kir zc
V, X	v x
LQIMHHFA, EBTB	lqimhhfa ebtb
K, W	k w
GGTFEOQN, AI	ggtfeoqn ai
YLP, R	ylp r
XTNCJYMT, XCQXAZBOCVLQZV	xtncjymt xcqxazbocvlqzv
LUVRBU, F	luvrbu f
L, S	l s
OU, V	ou v
UKLG, AWFCRX	uklg awfcrx
R, YM	r ym
GME, GF	gme gf
NGJY, O	ngjy o
QD, OD	qd od
OLOEQ, BTTF	oloeq bttf
Z, ZYDVEE	z zydvee
F, Q	f q
QOQ, W	qoq w
U, QZOG	u qzog
NE, EL	ne el
ZS, KCH	zs kch
KQDA, C	kqda c
R, XUMVM	r xumvm
N, V	n v
D, X	d x
KU, K	ku k
M, U	m u
PEI, KDV	pei kdv
T, WMYHBP	t wmyhbp
OMHL, VHAGF	omhl vhagf
C, D	c d
PX, CY	px cy
H, SQ	h sq
U, LK	u lk
R, OILCTSUZ	r oilctsuz
NGF, E	ngf e
V, BW	v bw
LM, C	lm c
Z, YQ	z yq
JZY, B	jzy b
ULE, ES	ule es
MWUL, O	mwul o
LY, G	ly g
N, Q	n q
B, HA	b ha
J, LN	j ln
EHX, AK	ehx ak
A, YHRHOL	a yhrhol
PHP, XH	php xh
M, E	m e
F, CT	f ct
J, QSBGP	j qsbgp
VF, VL	vf vl
PMHL, CXSYN	pmhl cxsyn
L, ZT	l zt
NO, L	no l
R, D	r d
J, AZDL	j azdl
H, A	h a
I, Q	i q
AWTKRP, X	awtkrp x
R, I	r i
AZTR, NS	aztr ns
CGAKNXH, XNS	cgaknxh xns
T, CIC	t cic
GD, ZAZZ	gd zazz
T, LXSK	t lxsk
S, US	s us
VL, WRDGSPG	vl wrdgspg
ISTT, DZON	istt dzon
E, M	e m
PFTLNQ, F	pftlnq f
LGIXSP, PWIYQ	lgixsp pwiyq
DXO, LMY	dxo lmy
OJTKG, Z	ojtkg z
BDPHTWQ, PQAM	bdphtwq pqam
OU, F	ou f
QYGT, YE	qygt ye
LRKX, R	lrkx r
CSBKF, HSO	csbkf hso
UG, WUV	ug wuv
WZPO, RL	wzpo rl
P, U	p u
YNHKT, QRP	ynhkt qrp
N, GODJL	n godjl
L, O	l o
W, UUQ	w uuq
I, C	i c
MFQH, HNQD	mfqh hnqd
A, RBQ	a rbq
P, RTJZTGCIFIEL	p rtjztgcifiel
EY, RNINB	ey rninb
ZMCW, QUQKTVJKXWWHK	zmcw quqktvjkxwwhk
Y, SG	y sg
BSH, SEGP	bsh segp
SKREXR, E	skrexr e
OGOD, Q	ogod q
P, SDLO	p sdlo
ST, H	st h
JF, P	jf p
F, B	f b
UPOXUEWUA, J	upoxuewua j
O, WXP	o wxp
H, O	h o
JQ, A	jq a
I, R	i r
W, U	w u
VGG, Y	vgg y
LSTSU, AE	lstsu ae
OMPYX, L	ompyx l
L, O	l o
HOY, LN	hoy ln
HY, URCXOR	hy urcxor
S, IA	s ia
SU, E	su e
T, Y	t y
KYA, CCMBHHMBN	kya ccmbhhmbn
MBKMG, KTO	mbkmg kto
K, J	k j
OH, QLY	oh qly
IYI, G	iyi g
U, X	u x
VVMVV, C	vvmvv c
W, IPEYSZTH	w ipeyszth
C, A	c a
DDKH, GOPGIXDJT	ddkh gopgixdjt
Q, DY	q dy
SGQ, CT	sgq ct
V, TJV	v tjv
XNAKAZ, OWIQ	xnakaz owiq
BU, DB	bu db
M, ZK	m zk
L, R	l r
VOM, U	vom u
F, XX	f xx
QO, CJJ	qo cjj
Y, UUP	y uup
C, X	c x
B, K	b k
V, G	v g
WSPQ, HH	wspq hh
JYO, HSAZUHMI	jyo hsazuhmi
JNGH, G	jngh g
J, UMU	j umu
DPRSS, G	dprss g
TC, P	tc p
HNBXVXEG, SC	hnbxvxeg sc
N, BLL	n bll
N, C	n c
MDH, L	mdh l
CPO, W	cpo w
RVO, VNB	rvo vnb
W, A	w a
Z, B	z b
T, RCRDFAH	t rcrdfah
A, X	a x
NQZF, Z	nqzf z
RE, ENN	re enn
WNEOC, CZLB	wneoc czlb
A, HWE	a hwe
VHB, L	vhb l
G, Z	g z
TM, R	tm r
S, Q	s q
GBYJZXIF, UDL	gbyjzxif udl
P, R	p r
OCJLBKUTSY, M	ocjlbkutsy m
YSZ, QKXR	ysz qkxr
B, MQ	b mq
MXFEEZ, ZOFNZ	mxfeez zofnz
L, WE	l we
VG, IORXA	vg iorxa
N, AL	n al
U, VGOIGHZE	u vgoighze
J, WGS	j wgs
T, S	t s
GAXYC, EWW	gaxyc eww
PW, H	pw h
N, N	n n
LN, DI	ln di
G, GGAD	g ggad
ZG, S	zg s
SFWQYQD, MI	sfwqyqd mi
U, H	u h
ANHNPA, KPP	anhnpa kpp
Q, GI	q gi
QR, QCNR	qr qcnr
H, N	h n
R, JMWHO	r jmwho
LI, Q	li q
W, KZOL	w kzol
KQ, IR	kq ir
SU, X	su x
DV, R	dv r
GC, M	gc m
TDA, D	tda d
BR, O	br o
W, MT	w mt
BGNHP, NB	bgnhp nb
AVXY, H	avxy h
I, UQ	i uq
WIQI, A	wiqi a
S, J	s j
K, H	k h
SY, B	sy b
N, Z	n z
C, BC	c bc
DVV, ETEKC	dvv etekc
CV, FSTLRL	cv fstlrl
K, EVWFFWTJ	k evwffwtj
AWUSCF, OD	awuscf od
DERY, U	dery u
R, LOO	r loo
PLMPAG, ZAP	plmpag zap
O, Q	o q
O, IC	o ic
N, SFBRRFYSR	n sfbrrfysr
F, D	f d
AA, P	aa p
E, VP	e vp
BJQ, RVG	bjq rvg
V, ESJSJTB	v esjsjtb
XPWH, EH	xpwh eh
CDI, TN	cdi tn
Y, M	y m
E, EQWL	e eqwl
X, FWB	x fwb
C, DE	c de
AQZ, YWXB	aqz ywxb
ZVNPXRO, YOD	zvnpxro yod
O, G	o g
EAFMSZD, Y	eafmszd y
TM, LQ	tm lq
X, QT	x qt
NE, YLD	ne yld
I, Q	i q
FZQ, QZ	fzq qz
BNOBW, VQ	bnobw vq
WA, CBD	wa cbd
V, LXMI	v lxmi
Z, R	z r
DGGJGM, XN	dggjgm xn
HLLA, GSAH	hlla gsah
F, T	f t
YV, E	yv e
AQZA, M	aqza m
IVI, Z	ivi z
XO, OQCQK	xo oqcqk
R, M	r m
Y, UC	y uc
D, PM	d pm
X, H	x h
RJGWMOWZTR, S	rjgwmowztr s
ZGYMLJ, KAZAQRHONBYXEL	zgymlj kazaqrhonbyxel
MX, MN	mx mn
E, XVLQYGAL	e xvlqygal
S, BE	s be
JVGSWVGEA, E	jvgswvgea e
I, V	i v
RLTPS, WUNDO	rltps wundo
K, XTJZ	k xtjz
BWRH, ID	bwrh id
R, J	r j
NF, VZ	nf vz
QN, PVLXED	qn pvlxed
W, E	w e
FXMM, UZ	fxmm uz
XKRKJ, OOK	xkrkj ook
J, DIU	j diu
L, IP	l ip
V, FKHWKLGIYZ	v fkhwklgiyz
OF, PQTTFI	of pqttfi
KE, T	ke t
D, Z	d z
KES, DH	kes dh
UOXAR, GK	uoxar gk
HU, U	hu u
M, MD	m md
J, F	j f
U, UBYQ	u ubyq
JFXCZ, GES	jfxcz ges
NHR, FZMH	nhr fzmh
J, U	j u
O, IG	o ig
JDSAOAW, F	jdsaoaw f
Q, Y	q y
KMBG, SZPYIU	kmbg szpyiu
WEBMT, MSDTQ	webmt msdtq
U, TW	u tw
MF, DWHBWJAXWT	mf dwhbwjaxwt
TW, S	tw s
BW, VT	bw vt
YPHYLMU, CJ	yphylmu cj
ZPSCRKF, O	zpscrkf o
JY, G	jy g
S, U	s u
OIW, KRQ	oiw krq
II, O	ii o
W, R	w r
J, AZBS	j azbs
FFJGS, AUF	ffjgs auf
S, RK	s rk
FUN, CIVVDI	fun civvdi
QA, AK	qa ak
RV, VAQHYK	rv vaqhyk
C, LQE	c lqe
K, M	k m
T, QV	t qv
WES, FOA	wes foa
RMXKG, XH	rmxkg xh
YYLZ, B	yylz b
M, IYFUE	m iyfue
EE, R	ee r
MK, V	mk v
YL, RJWP	yl rjwp
J, RJQU	j rjqu
Y, K	y k
TSYKXA, IT	tsykxa it
XBM, TCQQL	xbm tcqql
BSQY, ABHI	bsqy abhi
Q, DGB	q dgb
AO, ZU	ao zu
I, S	i s
UJ, IM	uj im
FP, HH	fp hh
W, RVDP	w rvdp
GF, Z	gf z
HQ, VYE	hq vye
K, TV	k tv
U, JF	u jf
MVLXWBATQRTVAXT, EEN	mvlxwbatqrtvaxt een
MI, G	mi g
ZMQEL, PAT	zmqel pat
SK, D	sk d
M, QA	m qa
Y, V	y v
RZWK, F	rzwk f
B, JC	b jc
GYWTUHWXA, Q	gywtuhwxa q
TGXXRTWQ, N	tgxxrtwq n
C, PST	c pst
UVTLC, CNIP	uvtlc cnip
R, BRTZ	r brtz
NBPB, KZBO	nbpb kzbo
P, ZY	p zy
E, RK	e rk
AZGEQI, G	azgeqi g
XSWXYV, ZKH	xswxyv zkh
OBA, LMO	oba lmo
XM, UBNOJC	xm ubnojc
N, N	n n
BFY, T	bfy t
WPY, H	wpy h
G, BLZGO	g blzgo
P, VFGLDB	p vfgldb
TCD, KIMLU	tcd kimlu
L, TR	l tr
ZQCIQLQ, SKZ	zqciqlq skz
LDD, K	ldd k
LGJ, ZXB	lgj zxb
J, FHMJF	j fhmjf
RVF, X	rvf x
UL, YCP	ul ycp
E, P	e p
SNEDQ, MC	snedq mc
SRUUF, EK	sruuf ek
FKQ, WKX	fkq wkx
MW, FF	mw ff
G, C	g c
L, Q	l q
T, U	t u
FA, BZVCTKGNB	fa bzvctkgnb
XV, WVHQWM	xv wvhqwm
D, EFYGU	d efygu
SXKV, R	sxkv r
T, WXSSTU	t wxsstu
XWR, USO	xwr uso
F, SIQUHHU	f siquhhu
U, K	u k
KGK, OE	kgk oe
PR, XS	pr xs
GO, UO	go uo
L, WJ	l wj
J, VCP	j vcp
VS, K	vs k
B, Y	b y
B, KSCAM	b kscam
HAJU, H	haju h
N, NOMK	n nomk
GRO, Y	gro y
BI, LNE	bi lne
OKK, GFOWCGIV	okk gfowcgiv
V, DRD	v drd
NZUHSV, PO	nzuhsv po
WVS, FAMQPOOTODADVFK	wvs famqpootodadvfk
CALUNB, Y	calunb y
HEGIQUD, L	hegiqud l
MAQQ, P	maqq p
MPQHIZ, PMX	mpqhiz pmx
AIG, PBF	aig pbf
FZZ, T	fzz t
S, E	s e
E, JRB	e jrb
MYVGU, RF	myvgu rf
X, S	x s
WHH, SOA	whh soa
ODBT, C	odbt c
Z, HQ	z hq
WBWWX, VNM	wbwwx vnm
WHBJ, ZLQY	whbj zlqy
U, LR	u lr
UE, K	ue k
WGFYOFZCCDR, KS	wgfyofzccdr ks
U, G	u g
I, P	i p
Z, L	z l
B, K	b k
FES, BK	fes bk
EBKQ, P	ebkq p
G, QMINRV	g qminrv
A, VO	a vo
ANDM, QJQ	andm qjq
S, YVYGIS	s yvygis
R, ZWVX	r zwvx
I, XY	i xy
SL, E	sl e
Q, QZI	q qzi
KB, E	kb e
GRMWLLROE, K	grmwllroe k
MW, O	mw o
G, SNZ	g snz
Q, Q	q q
JW, P	jw p
P, A	p a
RZ, CD	rz cd
M, V	m v
R, EVHO	r evho
DJ, E	dj e
P, FOGG	p fogg
H, JKEB	h jkeb
I, OH	i oh
RJD, D	rjd d
IZAOY, TU	izaoy tu
W, FG	w fg
G, I	g i
PJV, QDRS	pjv qdrs
MHUS, PIV	mhus piv
U, Z	u z
AR, V	ar v
SYB, LS	syb ls
RN, IF	rn if
S, ESM	s esm
XHBBRV, X	xhbbrv x
A, FIEAUMF	a fieaumf
I, FMOLAJ	i fmolaj
TAV, W	tav w
U, WTK	u wtk
BAE, SW	bae sw
C, H	c h
WW, UUCQQQ	ww uucqqq
LG, K	lg k
JESAZMA, K	jesazma k
BYUBTTUM, LVY	byubttum lvy
M, W	m w
SSW, EH	ssw eh
O, AA	o aa
UOEURBN, YDRTF	uoeurbn ydrtf
EJ, Z	ej z
SARBM, JT	sarbm jt
DLY, QV	dly qv
WUBX, DA	wubx da
E, MA	e ma
SL, NSQY	sl nsqy
D, T	d t
VV, IQU	vv iqu
JA, A	ja a
LXUSYKR, W	lxusykr w
LFE, F	lfe f
SZD, K	szd k
Z, HNAAFL	z hnaafl
K, XVDT	k xvdt
JDS, U	jds u
Y, A	y a
HD, GTCAR	hd gtcar
FRO, M	fro m
KSPS, Q	ksps q
S, H	s h
Z, GX	z gx
OMA, F	oma f
CKO, XEEDN	cko xeedn
PO, LA	po la
RGVN, TPJVAB	rgvn tpjvab
SWPE, VG	swpe vg
SYHI, R	syhi r
I, TMHY	i tmhy
CH, P	ch p
M, UA	m ua
W, FZS	w fzs
ZSE, JJK	zse jjk
TS, FJH	ts fjh
UX, S	ux s
GEJY, Z	gejy z
IQX, C	iqx c
EGQX, S	egqx s
O, K	o k
ZN, GG	zn gg
UKTI, B	ukti b
JY, XHD	jy xhd
I, A	i a
OWC, E	owc e
T, ARM	t arm
GXSQ, EC	gxsq ec
LMB, GCSHQ	lmb gcshq
L, VL	l vl
LNF, JRPLOB	lnf jrplob
E, LGOX	e lgox
ZWHFVXW, HY	zwhfvxw hy
GMRTOF, JHJQUQSF	gmrtof jhjquqsf
JNA, GFOBWVEPXC	jna gfobwvepxc
DLGKYI, P	dlgkyi p
H, BGPVING	h bgpving
IK, PWCDWR	ik pwcdwr
GLNOI, TTCT	glnoi ttct
FB, P	fb p
FPM, GXRQ	fpm gxrq
YVY, UIZG	yvy uizg
ONT, JIZW	ont jizw
JHXH, CX	jhxh cx
R, MPG	r mpg
TBM, ONS	tbm ons
OQHJOR, B	oqhjor b
N, Q	n q
YSQK, NSO	ysqk nso
LT, FZW	lt fzw
Z, B	z b
IGL, AAY	igl aay
NY, B	ny b
U, JT	u jt
IRHNJ, A	irhnj a
JFS, M	jfs m
RQZ, HDWHGAPW	rqz hdwhgapw
A, QEF	a qef
JUGW, CL	jugw cl
WIOHSL, QHID	wiohsl qhid
OR, SPQIMW	or spqimw
ZT, WU	zt wu
L, IIMNT	l iimnt
VALRZ, E	valrz e
JDMWQEN, L	jdmwqen l
VII, A	vii a
EYFHA, KPG	eyfha kpg
GUJ, XOLU	guj xolu
ZUKAUS, ECEA	zukaus ecea
QDKZ, OT	qdkz ot
KDR, TU	kdr tu
HG, L	hg l
UOYO, C	uoyo c
K, UHKGHAI	k uhkghai
OF, F	of f
SBOIS, SA	sbois sa
Y, C	y c
E, G	e g
J, CC	j cc
YRXY, VEHV	yrxy vehv
FA, I	fa i
Y, A	y a
E, G	e g
AL, PD	al pd
HV, U	hv u
R, K	r k
T, QWO	t qwo
HU, X	hu x
HF, CAHB	hf cahb
PGDOC, ALU	pgdoc alu
A, D	a d
QX, TJQJHRKIKKLKSTSS	qx tjqjhrkikklkstss
IZLB, WPR	izlb wpr
YKY, FL	yky fl
U, M	u m
P, TW	p tw
ZW, U	zw u
I, H	i h
Z, N	z n
G, U	g u
A, SIAQEALHRKOPX	a siaqealhrkopx
MP, KW	mp kw
KTMD, CJP	ktmd cjp
GA, H	ga h
AAQ, W	aaq w
TU, DB	tu db
W, DSX	w dsx
XH, T	xh t
NLEN, NFEB	nlen nfeb
QUFLLUDQ, U	quflludq u
JZU, ABHB	jzu abhb
S, VJ	s vj
ZX, TP	zx tp
SM, NHZ	sm nhz
SW, XK	sw xk
EMJIB, G	emjib g
IF, CXJ	if cxj
VQ, AVS	vq avs
FYMDCU, S	fymdcu s
BI, ISU	bi isu
PMX, TXI	pmx txi
SRGEZTB, UDCUJDSZZC	srgeztb udcujdszzc
YBPYZ, U	ybpyz u
NZZ, MADA	nzz mada
S, R	s r
U, VC	u vc
UY, LO	uy lo
XU, YVOFWPPIFSMLB	xu yvofwppifsmlb
QF, D	qf d
H, B	h b
DXUVHS, J	dxuvhs j
C, LKL	c lkl
CQ, V	cq v
TK, LKCQ	tk lkcq
FMFCO, J	fmfco j
HQ, NK	hq nk
PNWY, Q	pnwy q
X, RG	x rg
IEBN, L	iebn l
O, E	o e
R, P	r p
Y, CGBK	y cgbk
TN, WO	tn wo
V, HDL	v hdl
RPWIGYU, AHVU	rpwigyu ahvu
CADWZQS, B	cadwzqs b
N, J	n j
A, HXI	a hxi
F, NQ	f nq
QDU, UIC	qdu uic
WJ, XAQA	wj xaqa
G, TK	g tk
E, G	e g
FR, A	fr a
JRXA, OOE	jrxa ooe
L, NO	l no
VIYTV, QLUTHBX	viytv qluthbx
K, WM	k wm
BVEM, B	bvem b
NS, UFJ	ns ufj
D, J	d j
SXN, UDI	sxn udi
UZP, Q	uzp q
NOZ, I	noz i
OHHR, SM	ohhr sm
YQ, H	yq h
UADJJS, U	uadjjs u
AL, RBAD	al rbad
TOO, VE	too ve
S, VZ	s vz
X, TE	x te
CAYUQPG, JFV	cayuqpg jfv
C, E	c e
I, G	i g
CV, LV	cv lv
OQ, J	oq j
DM, ARXEPA	dm arxepa
FW, YB	fw yb
DA, LI	da li
T, UUS	t uus
LH, H	lh h
E, M	e m
O, M	o m
U, UKIWW	u ukiww
P, VSGZI	p vsgzi
ARW, FO	arw fo
Y, IR	y ir
BU, L	bu l
AEIU, PM	aeiu pm
CW, HZT	cw hzt
VQHV, YY	vqhv yy
XCUBAJ, MWF	xcubaj mwf
AKA, LXHQP	aka lxhqp
Q, YV	q yv
BLY, U	bly u
QVZC, Q	qvzc q
YW, QHC	yw qhc
ROD, YOZ	rod yoz
R, JG	r jg
YG, ISTCFRZVU	yg istcfrzvu
F, MS	f ms
TN, D	tn d
ZK, ME	zk me
E, FBGXS	e fbgxs
KE, ZU	ke zu
IP, T	ip t
M, WCNX	m wcnx
U, NSWH	u nswh
Y, V	y v
W, Z	w z
J, TM	j tm
ETRMFXP, ANX	etrmfxp anx
KLSYD, P	klsyd p
AHLQ, QSY	ahlq qsy
TQE, WPATEQZEUVR	tqe wpateqzeuvr
TEZ, DZK	tez dzk
KAEOCK, IC	kaeock ic
RO, ZC	ro zc
HC, AFY	hc afy
ZL, H	zl h
REYQG, C	reyqg c
ES, AN	es an
L, BY	l by
JG, OVX	jg ovx
WK, KTC	wk ktc
PKLA, L	pkla l
PQKG, VRFNPAL	pqkg vrfnpal
ZR, EVTC	zr evtc
IFIR, I	ifir i
AUT, LR	aut lr
LZFNSEY, QRZGCIDNF	lzfnsey qrzgcidnf
J, IRNH	j irnh
QS, IWKV	qs iwkv
HOFRCPZ, Q	hofrcpz q
XDM, PK	xdm pk
S, S	s s
SN, ZVB	sn zvb
QZ, QNR	qz qnr
QEWB, A	qewb a
C, PNBCO	c pnbco
LLFSUF, YX	llfsuf yx
OJ, HX	oj hx
LLVGHMQ, ZW	llvghmq zw
FJ, L	fj l
GTSNMABZ, AQEU	gtsnmabz aqeu
BTLHC, VJZZAL	btlhc vjzzal
Z, HXZX	z hxzx
TRL, U	trl u
Q, N	q n
JV, EMQMGM	jv emqmgm
K, CWPPE	k cwppe
S, RJGH	s rjgh
M, ZN	m zn
V, K	v k
TW, ZJZ	tw zjz
NE, KS	ne ks
O, JPUMUW	o jpumuw
FO, LZR	fo lzr
VX, HGP	vx hgp
B, A	b a
Q, D	q d
TVII, UXZER	tvii uxzer
VA, KUG	va kug
CJG, ACAQJ	cjg acaqj
L, FF	l ff
PH, P	ph p
N, RB	n rb
DHJ, MDFN	dhj mdfn
O, D	o d
UA, P	ua p
ZM, ZIBKDORQQTBVQH	zm zibkdorqqtbvqh
C, ZDHUJBLJZ	c zdhujbljz
AMONGACMK, VYHAGXVKWUD	amongacmk vyhagxvkwud
RE, MJ	re mj
ZEI, G	zei g
IZP, QF	izp qf
YCK, ON	yck on
SVAZOCL, SU	svazocl su
NC, M	nc m
PT, A	pt a
G, Y	g y
MC, T	mc t
HEN, JPGXOA	hen jpgxoa
SX, K	sx k
WN, Y	wn y
KRE, JFSCUUUTM	kre jfscuuutm
J, RIQ	j riq
NFUIW, A	nfuiw a
W, Y	w y
U, M	u m
NR, FQSGHM	nr fqsghm
FUJ, TZN	fuj tzn
AC, VA	ac va
AQ, S	aq s
THF, RR	thf rr
RX, SBL	rx sbl
U, NY	u ny
L, EH	l eh
O, T	o t
BF, B	bf b
OBTFNJZD, K	obtfnjzd k
K, K	k k
J, AW	j aw
F, QW	f qw
X, I	x i
W, JSHX	w jshx
MT, KXL	mt kxl
M, UU	m uu
WOPYZ, Z	wopyz z
H, IM	h im
ALJJ, Y	aljj y
NEAB, S	neab s
U, A	u a
G, GENLAM	g genlam
HDCL, C	hdcl c
O, E	o e
H, W	h w
JWFZ, DW	jwfz dw
G, NT	g nt
NMA, ULBFTXSH	nma ulbftxsh
A, D	a d
PCQ, JU	pcq ju
YQDLS, WA	yqdls wa
V, Z	v z
E, E	e e
LHD, ZTD	lhd ztd
RP, CQZDNN	rp cqzdnn
LATJ, L	latj l
PT, F	pt f
YPKQDE, M	ypkqde m
R, T	r t
B, Y	b y
D, UJ	d uj
AJIU, LF	ajiu lf
O, X	o x
DH, GUNWA	dh gunwa
OVPU, B	ovpu b
O, OK	o ok
DWU, ZR	dwu zr
C, O	c o
WC, QH	wc qh
R, Y	r y
DSMHL, M	dsmhl m
POVH, Z	povh z
U, K	u k
F, WOCKEPZKO	f wockepzko
CF, BU	cf bu
V, OQ	v oq
G, D	g d
FON, Z	fon z
RH, LCOW	rh lcow
HSD, KYS	hsd kys
TQ, VFMRB	tq vfmrb
MNOINK, NCDPRB	mnoink ncdprb
V, OVB	v ovb
PQ, ZZJ	pq zzj
Q, BX	q bx
P, S	p s
E, RXF	e rxf
QLPOV, RBO	qlpov rbo
T, KCEVAS	t kcevas
GXKQ, LQWWUT	gxkq lqwwut
JOCXJ, ILF	jocxj ilf
QKW, N	qkw n
N, IW	n iw
R, LXQKR	r lxqkr
Z, GKCL	z gkcl
THN, XQJK	thn xqjk
HJ, AZPRUJF	hj azprujf
XRTWKSVRM, J	xrtwksvrm j
G, TQ	g tq
LSFCZO, HRTNR	lsfczo hrtnr
MX, UNLZQKOU	mx unlzqkou
G, IIIF	g iiif
E, A	e a
LHPJF, CP	lhpjf cp
XOX, J	xox j
V, KGGQPC	v kggqpc
NWRYV, RB	nwryv rb
OEMB, G	oemb g
LCH, U	lch u
W, IPFE	w ipfe
KECWTZLY, T	kecwtzly t
C, AEXKH	c aexkh
SR, FV	sr fv
P, K	p k
I, YIJFL	i yijfl
TK, I	tk i
D, W	d w
H, VRXXQW	h vrxxqw
HHTXSLZ, K	hhtxslz k
Y, XEB	y xeb
SY, GWS	sy gws
VSH, BYJZX	vsh byjzx
G, IBHK	g ibhk
LW, YNYLHVWE	lw ynylhvwe
RV, N	rv n
LB, QQ	lb qq
H, SL	h sl
NU, YO	nu yo
T, KYN	t kyn
S, FQECKJ	s fqeckj
YA, EL	ya el
M, BLQXG	m blqxg
EBGBJV, U	ebgbjv u
ZG, CKLQ	zg cklq
C, RJ	c rj
ZVLM, SIYHUL	zvlm siyhul
TS, AIAZCLFKSP	ts aiazclfksp
M, S	m s
DFY, XRCQC	dfy xrcqc
VKTVTP, PN	vktvtp pn
VDMF, V	vdmf v
RD, ZT	rd zt
E, S	e s
E, Z	e z
AAV, F	aav f
K, KJ	k kj
NO, I	no i
XC, UMQIQYX	xc umqiqyx
T, R	t r
SJULWX, MKA	sjulwx mka
TKQK, JP	tkqk jp
K, VLF	k vlf
R, LWN	r lwn
OY, VN	oy vn
A, J	a j
KW, PMP	kw pmp
P, TKKK	p tkkk
I, X	i x
KQF, V	kqf v
XB, FKG	xb fkg
Z, A	z a
W, A	w a
ME, PYWF	me pywf
HKSI, E	hksi e
I, LE	i le
CM, Z	cm z
ED, Q	ed q
X, O	x o
WDDBUW, BK	wddbuw bk
Y, D	y d
D, C	d c
R, BH	r bh
CMP, FBHV	cmp fbhv
EIV, CHG	eiv chg
GM, MW	gm mw
I, JFYDUOOBMD	i jfyduoobmd
K, FA	k fa
KMRHL, O	kmrhl o
TU, LWPZ	tu lwpz
X, Q	x q
VVGNIP, HYBWMXXPXSI	vvgnip hybwmxxpxsi
NB, HD	nb hd
V, S	v s
A, JVMAOL	a jvmaol
SOJ, WD	soj wd
G, OP	g op
GKJ, KNG	gkj kng
QCA, AHWWPI	qca ahwwpi
IB, N	ib n
SHC, RD	shc rd
C, S	c s
Q, NO	q no
WR, GL	wr gl
UBKTLPFOU, BF	ubktlpfou bf
HG, KOMVG	hg komvg
YYDTY, QH	yydty qh
J, JVP	j jvp
WAX, OL	wax ol
AZG, D	azg d
EEDPBJB, Z	eedpbjb z
QI, G	qi g
G, NIFN	g nifn
WE, N	we n
MWV, O	mwv o
RAUXAIBTAH, CVIYRXTE	rauxaibtah cviyrxte
SBU, Z	sbu z
PGCCD, D	pgccd d
EFT, UU	eft uu
NE, L	ne l
IF, YRGX	if yrgx
SW, Q	sw q
HF, PSNGZT	hf psngzt
GFMZVM, X	gfmzvm x
D, TN	d tn
PX, ZZRC	px zzrc
KLH, D	klh d
MNN, J	mnn j
LNW, T	lnw t
OW, OG	ow og
ZK, DB	zk db
QRA, XK	qra xk
TMQY, BC	tmqy bc
A, V	a v
G, EF	g ef
AVZ, EBHO	avz ebho
E, E	e e
QPVZPJQ, U	qpvzpjq u
RD, LW	rd lw
EBVYT, CL	ebvyt cl
YIYUEDNIC, CQ	yiyuednic cq
E, S	e s
KSYC, NFKWV	ksyc nfkwv
J, COGQC	j cogqc
PM, HB	pm hb
AZG, R	azg r
L, CNLAP	l cnlap
AE, U	ae u
TIKDK, YTDQ	tikdk ytdq
SA, NM	sa nm
BJ, NH	bj nh
GV, Y	gv y
DI, J	di j
V, Z	v z
SKVT, U	skvt u
KOXMZ, C	koxmz c
DW, K	dw k
V, Y	v y
ON, TA	on ta
V, T	v t
NRDXJC, QO	nrdxjc qo
U, XMY	u xmy
GK, PJHKWQZLQ	gk pjhkwqzlq
I, HCRJ	i hcrj
GIZLQT, MZYF	gizlqt mzyf
ZU, LPK	zu lpk
EWG, HLK	ewg hlk
D, Q	d q
N, BJ	n bj
DW, UO	dw uo
VRIRYG, Z	vriryg z
O, WZQ	o wzq
XJ, X	xj x
LM, ZHFZZKTEWMUOW	lm zhfzzktewmuow
FW, S	fw s
ZQJV, ARTKXRYJM	zqjv artkxryjm
A, V	a v
T, G	t g
M, YO	m yo
IV, LR	iv lr
UAJLW, S	uajlw s
G, FEN	g fen
QQ, HK	qq hk
LMA, E	lma e
OV, ECQOY	ov ecqoy
CZAIUWUCF, T	czaiuwucf t
L, MEWUNT	l mewunt
CW, YVDPZUEIUS	cw yvdpzueius
YAJGPDE, CD	yajgpde cd
XZ, TL	xz tl
LWRBS, OSNS	lwrbs osns
R, JHI	r jhi
LYVJBZ, JSGT	lyvjbz jsgt
W, LNSKI	w lnski
VKZUSNRMCNO, TNKT	vkzusnrmcno tnkt
RV, CZ	rv cz
QRLW, VOQR	qrlw voqr
BK, BSV	bk bsv
UF, LLW	uf llw
H, AU	h au
PCDQ, V	pcdq v
L, G	l g
QS, H	qs h
GVZ, T	gvz t
TPQBHHE, D	tpqbhhe d
RW, CPNM	rw cpnm
AJ, NB	aj nb
J, OJS	j ojs
WVUKVAY, IHY	wvukvay ihy
WFINM, IQJK	wfinm iqjk
E, DT	e dt
H, C	h c
GV, UXFSQ	gv uxfsq
NHI, DHWO	nhi dhwo
YH, S	yh s
LDR, E	ldr e
MP, OR	mp or
V, SZN	v szn
DRW, Y	drw y
PQM, JDNB	pqm jdnb
QPBDK, I	qpbdk i
YYNLL, GF	yynll gf
MX, ON	mx on
Z, MPYFOGPD	z mpyfogpd
B, Q	b q
AZHJX, JTQCP	azhjx jtqcp
AU, VLDLTKGF	au vldltkgf
Y, NRQHM	y nrqhm
B, K	b k
XM, P	xm p
JK, W	jk w
OY, J	oy j
XM, C	xm c
N, JM	n jm
FUDOO, L	fudoo l
ZZBP, A	zzbp a
A, H	a h
B, H	b h
WSLAMA, OMUY	wslama omuy
VQ, T	vq t
RUIWUH, L	ruiwuh l
HRMX, T	hrmx t
ZV, R	zv r
J, V	j v
DRWTIMW, XPN	drwtimw xpn
NSOPDMVITUKH, O	nsopdmvitukh o
T, QTW	t qtw
RI, BH	ri bh
YYR, V	yyr v
DDYC, W	ddyc w
YD, CC	yd cc
O, P	o p
CKPKOPX, RI	ckpkopx ri
K, G	k g
EP, X	ep x
QJT, J	qjt j
CKF, VV	ckf vv
DBONIUPM, BB	dboniupm bb
IGAL, H	igal h
IT, LARC	it larc
SU, RH	su rh
G, W	g w
C, BI	c bi
KKD, R	kkd r
UPE, FTO	upe fto
N, L	n l
SX, KRF	sx krf
E, PM	e pm
RIJNJPX, T	rijnjpx t
ZHS, V	zhs v
C, MDK	c mdk
S, U	s u
CLQMR, XAGK	clqmr xagk
CYZR, TIYO	cyzr tiyo
EQZ, VYMM	eqz vymm
U, KK	u kk
J, K	j k
U, G	u g
D, S	d s
IDJ, LRGR	idj lrgr
Q, Z	q z
SJEATLA, Y	sjeatla y
LXA, K	lxa k
OMVSM, Y	omvsm y
YSK, EGKZGKF	ysk egkzgkf
PVB, MPPAE	pvb mppae
CLDJPV, WBJNL	cldjpv wbjnl
CXDWJCS, U	cxdwjcs u
V, K	v k
G, VO	g vo
SZPQ, XME	szpq xme
V, MKTHJW	v mkthjw
WI, OXI	wi oxi
E, QB	e qb
A, XZ	a xz
M, AD	m ad
GQ, SFZI	gq sfzi
H, DQZUW	h dqzuw
S, TO	s to
O, SEFXC	o sefxc
Q, XQR	q xqr
U, MBTG	u mbtg
JJD, DKN	jjd dkn
D, EGYHD	d egyhd
R, DC	r dc
Z, S	z s
RL, HL	rl hl
WHZ, VC	whz vc
O, SA	o sa
KQ, BDAEMZRL	kq bdaemzrl
KLB, P	klb p
UN, GP	un gp
HH, Y	hh y
BC, GBT	bc gbt
ELP, BCTU	elp bctu
E, M	e m
ZWMVO, L	zwmvo l
KXD, F	kxd f
T, U	t u
STQ, DAU	stq dau
WNTB, A	wntb a
Q, CX	q cx
YG, L	yg l
F, TEB	f teb
XOK, WK	xok wk
YUQF, LJ	yuqf lj
VF, LVEA	vf lvea
M, SS	m ss
IA, S	ia s
E, UHSRE	e uhsre
OTMM, LZ	otmm lz
RPU, H	rpu h
Y, W	y w
RKFK, I	rkfk i
RJZ, HUA	rjz hua
FE, F	fe f
ZNE, DZ	zne dz
W, B	w b
CYF, JTT	cyf jtt
OO, JYM	oo jym
QBJ, XS	qbj xs
F, FYHQBTJA	f fyhqbtja
AGI, U	agi u
MM, G	mm g
W, X	w x
B, Q	b q
RDRI, VGX	rdri vgx
S, A	s a
R, O	r o
XBK, O	xbk o
L, BH	l bh
TDR, H	tdr h
ANP, RUYMR	anp ruymr
U, F	u f
UMFH, EB	umfh eb
YH, A	yh a
I, ICESY	i icesy
LY, G	ly g
O, Q	o q
SNVBZL, ZCGFAOVX	snvbzl zcgfaovx
I, ZFAC	i zfac
BN, O	bn o
ETTYWF, T	ettywf t
X, XGI	x xgi
HCGT, SXKTZ	hcgt sxktz
UR, NZ	ur nz
YLT, I	ylt i
OFAK, Z	ofak z
YK, Y	yk y
G, EQKC	g eqkc
B, T	b t
G, DU	g du
DKCAQBCHVBNBQZ, OZQY	dkcaqbchvbnbqz ozqy
D, L	d l
NOH, NR	noh nr
QAH, N	qah n
OEFN, SDI	oefn sdi
Z, DT	z dt
OOA, I	ooa i
B, VNZ	b vnz
R, S	r s
A, KY	a ky
F, G	f g
BPT, KOGCM	bpt kogcm
OO, ZVG	oo zvg
TB, H	tb h
T, UEY	t uey
Z, YI	z yi
Q, Z	q z
HPINW, N	hpinw n
E, VC	e vc
QDRB, ZZL	qdrb zzl
JG, N	jg n
K, M	k m
E, T	e t
NK, ZJ	nk zj
O, DIH	o dih
F, HIUYHWV	f hiuyhwv
IU, BUD	iu bud
QI, V	qi v
H, LT	h lt
MQ, B	mq b
DEEJS, MHQSK	deejs mhqsk
PNO, CPBS	pno cpbs
WFXPBVVAL, DSKOR	wfxpbvval dskor
RU, Q	ru q
V, QNGKNV	v qngknv
F, P	f p
S, J	s j
K, K	k k
A, P	a p
QCB, JZAZ	qcb jzaz
V, IH	v ih
Y, ZCL	y zcl
FN, J	fn j
OU, NXEV	ou nxev
X, W	x w
D, HRX	d hrx
YI, YP	yi yp
AT, K	at k
R, U	r u
RV, LU	rv lu
U, OZ	u oz
ZA, RQVRO	za rqvro
TPT, W	tpt w
DCO, MCLZK	dco mclzk
U, F	u f
C, K	c k
EY, QK	ey qk
L, R	l r
UB, LP	ub lp
J, S	j s
X, WEX	x wex
T, Q	t q
OR, EW	or ew
S, FK	s fk
D, HW	d hw
NDFTN, RRN	ndftn rrn
T, QDZJL	t qdzjl
R, M	r m
WE, X	we x
HM, T	hm t
QTHFC, CDPGNV	qthfc cdpgnv
GJK, W	gjk w
DHBF, W	dhbf w
WJRD, F	wjrd f
EEBJ, VV	eebj vv
Z, PORTYAMVGL	z portyamvgl
VW, GFIBFKJZL	vw gfibfkjzl
US, D	us d
P, M	p m
T, FRP	t frp
Q, N	q n
P, IC	p ic
AKLTIRUEIGR, JY	akltirueigr jy
V, W	v w
RY, QIXGVJ	ry qixgvj
W, G	w g
W, DRX	w drx
UUMP, D	uump d
XV, OOXCA	xv ooxca
YP, EAM	yp eam
MQMT, WJ	mqmt wj
NDN, F	ndn f
ZN, CCYQ	zn ccyq
Q, F	q f
USY, FP	usy fp
DHFWQMQG, YU	dhfwqmqg yu
Y, MQORUK	y mqoruk
LI, CKE	li cke
K, TVUWD	k tvuwd
GOW, F	gow f
LZTIA, GMEY	lztia gmey
D, G	d g
K, EMD	k emd
EA, M	ea m
VKSUA, N	vksua n
P, P	p p
VTG, FTE	vtg fte
A, Q	a q
STHBM, QO	sthbm qo
VAX, L	vax l
VE, QUM	ve qum
XS, L	xs l
J, KQ	j kq
A, T	a t
D, GRAQOP	d graqop
A, WDX	a wdx
DHOP, GF	dhop gf
N, IQJ	n iqj
DT, LGM	dt lgm
JRP, X	jrp x
H, K	h k
XL, XMDU	xl xmdu
E, BE	e be
CY, QDD	cy qdd
T, B	t b
JBB, IDFMR	jbb idfmr
F, ZDHIV	f zdhiv
RDY, DTCE	rdy dtce
XPJEZKEDKE, F	xpjezkedke f
FHCA, EL	fhca el
Z, ODG	z odg
XB, C	xb c
IN, ING	in ing
PFNXHIQPDHC, KQHZA	pfnxhiqpdhc kqhza
PH, XNYPNUXJO	ph xnypnuxjo
SFD, N	sfd n
C, C	c c
G, BO	g bo
CYTXMIA, U	cytxmia u
Y, N	y n
KDRVLVNITV, WTQL	kdrvlvnitv wtql
J, CRDHHNKN	j crdhhnkn
MW, J	mw j
HG, I	hg i
O, D	o d
OB, MSMAGCRIO	ob msmagcrio
L, A	l a
F, UQZRC	f uqzrc
Z, YTU	z ytu
E, L	e l
I, C	i c
ZARGUH, MPP	zarguh mpp
BMV, VQA	bmv vqa
PN, SU	pn su
AXB, DWZBJ	axb dwzbj
AX, AI	ax ai
L, U	l u
JMS, W	jms w
RR, Q	rr q
CA, Y	ca y
I, MA	i ma
YB, VF	yb vf
N, KQ	n kq
WXLV, O	wxlv o
UMD, RU	umd ru
F, DR	f dr
XOAV, Z	xoav z
ASZEC, AHD	aszec ahd
I, Y	i y
VRJA, K	vrja k
A, XH	a xh
DCTJTDQ, BTJLWNYZ	dctjtdq btjlwnyz
GI, E	gi e
K, WSOYPSDSVY	k wsoypsdsvy
VXWGMVJ, RGESI	vxwgmvj rgesi
NWZCRLPNRS, Y	nwzcrlpnrs y
W, PGX	w pgx
JV, M	jv m
DXA, PF	dxa pf
SPIVXLS, NROXASRQII	spivxls nroxasrqii
X, L	x l
LFHO, MBGCBRDA	lfho mbgcbrda
PY, JVC	py jvc
QD, O	qd o
A, C	a c
M, B	m b
LM, WFDZ	lm wfdz
N, A	n a
YVNX, SX	yvnx sx
CL, B	cl b
Q, Y	q y
UEPLEBZILKJP, WK	ueplebzilkjp wk
DY, DV	dy dv
OT, APSO	ot apso
OO, CO	oo co
AWRF, UUWXNCM	awrf uuwxncm
YUBRE, TX	yubre tx
QEAQ, PBP	qeaq pbp
ZA, X	za x
GD, UPTVJPYWZF	gd uptvjpywzf
Y, BFO	y bfo
GTN, JEF	gtn jef
T, F	t f
FCKRSNDXU, GEKV	fckrsndxu gekv
J, YBZ	j ybz
T, V	t v
QQU, FWB	qqu fwb
OTITK, RRQBXC	otitk rrqbxc
SH, UZ	sh uz
VPW, MJINC	vpw mjinc
YJ, Q	yj q
P, M	p m
O, W	o w
DRCQ, N	drcq n
I, XOGUITB	i xoguitb
AMNU, SS	amnu ss
YL, FWN	yl fwn
I, Z	i z
D, WLFPU	d wlfpu
P, FDMQJI	p fdmqji
P, S	p s
QJ, NFG	qj nfg
BR, WI	br wi
Y, L	y l
H, ZQEGI	h zqegi
Z, Z	z z
U, GF	u gf
UQO, MCEC	uqo mcec
JJI, PDJRS	jji pdjrs
I, DCQ	i dcq
ZRVU, A	zrvu a
DAGY, GZ	dagy gz
JKD, O	jkd o
RD, C	rd c
OMN, TY	omn ty
F, D	f d
Z, WA	z wa
ZHET, HP	zhet hp
P, W	p w
F, PIIVG	f piivg
U, AFPDJLO	u afpdjlo
M, I	m i
YA, JUBN	ya jubn
F, O	f o
SZB, A	szb a
T, W	t w
CY, Y	cy y
FK, QR	fk qr
B, VUERHH	b vuerhh
Q, CL	q cl
YUUJT, J	yuujt j
D, AH	d ah
D, AG	d ag
TZSSCNHN, VU	tzsscnhn vu
VNLYAX, HKRMSW	vnlyax hkrmsw
Q, GSL	q gsl
R, M	r m
NVEW, DA	nvew da
RFU, HI	rfu hi
R, LQ	r lq
BA, FKGRC	ba fkgrc
R, I	r i
M, C	m c
T, HCK	t hck
FABXJTDZD, ECXXUHY	fabxjtdzd ecxxuhy
NIN, R	nin r
VNZ, OGQY	vnz ogqy
I, ZZGDR	i zzgdr
BGAI, BGUQJS	bgai bguqjs
ID, L	id l
UIGJMSNKADUU, PXFB	uigjmsnkaduu pxfb
CAIG, IQ	caig iq
CVG, H	cvg h
Z, PKWB	z pkwb
KNCRLCWO, CGLTUUIYE	kncrlcwo cgltuuiye
Z, WBO	z wbo
AOMXYY, G	aomxyy g
A, S	a s
L, DC	l dc
ND, R	nd r
XQDYM, T	xqdym t
M, SN	m sn
OEEM, W	oeem w
I, WS	i ws
Q, DW	q dw
ZV, W	zv w
BR, FN	br fn
SB, ANCK	sb anck
IC, Y	ic y
Z, Y	z y
XY, BNMOME	xy bnmome
KL, HU	kl hu
YJ, MC	yj mc
YA, PVW	ya pvw
V, PKQ	v pkq
HI, JN	hi jn
PKSOM, QX	pksom qx
GPUD, WU	gpud wu
B, SR	b sr
A, P	a p
M, T	m t
B, HOCS	b hocs
LPIAZ, E	lpiaz e
FA, VZMR	fa vzmr
YV, M	yv m
PM, PPAKQKRS	pm ppakqkrs
HYJ, RIIE	hyj riie
VQ, XW	vq xw
P, X	p x
S, NQNVT	s nqnvt
V, BZO	v bzo
II, T	ii t
BTI, S	bti s
BWB, CN	bwb cn
T, D	t d
EXRUN, FMCKSM	exrun fmcksm
I, BIBV	i bibv
PX, ICONSV	px iconsv
LWW, F	lww f
BR, WW	br ww
G, BEVDAM	g bevdam
XUQ, GNVC	xuq gnvc
I, AJOKIRPGH	i ajokirpgh
F, GRE	f gre
FPTV, OF	fptv of
D, M	d m
EMQX, Z	emqx z
V, Y	v y
B, HV	b hv
PY, D	py d
I, JFDX	i jfdx
JPZH, L	jpzh l
F, A	f a
CFFOJFLK, GBPQ	cffojflk gbpq
QC, C	qc c
OI, RV	oi rv
W, V	w v
WJFHC, PUQ	wjfhc puq
QPX, GMPU	qpx gmpu
S, MY	s my
P, KQEZP	p kqezp
X, B	x b
G, UVV	g uvv
ICJOVV, UY	icjovv uy
NRVVUV, H	nrvvuv h
LUB, KJC	lub kjc
P, U	p u
FF, YU	ff yu
YH, A	yh a
JZ, BVZW	jz bvzw
BC, SB	bc sb
V, XMZ	v xmz
LY, TW	ly tw
JV, S	jv s
E, LL	e ll
RS, OQ	rs oq
KDJ, R	kdj r
J, M	j m
J, W	j w
FXZ, U	fxz u
WO, J	wo j
N, AJ	n aj
BH, PQ	bh pq
AR, J	ar j
C, UG	c ug
WRHQ, I	wrhq i
LSV, L	lsv l
MLOI, I	mloi i
BX, YEM	bx yem
V, G	v g
OX, BXG	ox bxg
N, GN	n gn
H, FXWQ	h fxwq
JFUFOE, KXZ	jfufoe kxz
T, HJ	t hj
JM, U	jm u
F, EJCC	f ejcc
O, PSQG	o psqg
WJ, HI	wj hi
H, N	h n
UBX, NRYOW	ubx nryow
ZMK, EW	zmk ew
NYJ, OQI	nyj oqi
UJFOO, CSYVYCUGZ	ujfoo csyvycugz
M, UNVEXM	m unvexm
P, E	p e
G, E	g e
GXZAJ, GZ	gxzaj gz
Q, WY	q wy
X, J	x j
BPHSHX, WQI	bphshx wqi
MHE, UMK	mhe umk
B, Y	b y
P, M	p m
H, IYO	h iyo
TJ, PDW	tj pdw
P, A	p a
UZTQIFYSK, J	uztqifysk j
T, B	t b
COSZCF, V	coszcf v
OVKWWFZ, VTSJ	ovkwwfz vtsj
G, X	g x
ER, L	er l
LX, RW	lx rw
HYTS, HH	hyts hh
YZII, Y	yzii y
DGVCMR, LIW	dgvcmr liw
NHU, LR	nhu lr
UXE, M	uxe m
CC, F	cc f
GFUM, E	gfum e
EG, FPOT	eg fpot
XXF, I	xxf i
FJ, O	fj o
QV, WARQ	qv warq
UQ, JHXKPN	uq jhxkpn
YBK, UX	ybk ux
Z, GOUWCHSZMQYF	z gouwchszmqyf
BEI, GYJ	bei gyj
SOBCM, U	sobcm u
XBWI, Q	xbwi q
NJP, S	njp s
O, U	o u
CPI, O	cpi o
LF, H	lf h
RF, W	rf w
GVP, AQTJ	gvp aqtj
DGNT, F	dgnt f
UPWAD, BC	upwad bc
JVGOL, XD	jvgol xd
IT, BD	it bd
T, J	t j
JX, N	jx n
JI, R	ji r
K, K	k k
ONK, VELUUY	onk veluuy
XDC, R	xdc r
O, L	o l
E, OK	e ok
M, N	m n
WOGVRU, QE	wogvru qe
U, F	u f
X, KWYK	x kwyk
XNTJ, HO	xntj ho
L, EM	l em
OO, HOLU	oo holu
SISJHQ, ZVWF	sisjhq zvwf
KULCZ, C	kulcz c
HJK, MBNOJX	hjk mbnojx
HF, MIJBRYM	hf mijbrym
IUSR, D	iusr d
AG, L	ag l
FP, Y	fp y
Z, K	z k
KHHALUZ, AYBYFNI	khhaluz aybyfni
LIUDL, Y	liudl y
W, GPI	w gpi
WPIS, KTCBZS	wpis ktcbzs
K, UB	k ub
COA, V	coa v
A, BORAHJRB	a borahjrb
KA, WX	ka wx
B, D	b d
Y, R	y r
UC, B	uc b
DCMFF, FTHEPXZWA	dcmff fthepxzwa
NJ, ERPPLAI	nj erpplai
XW, EWH	xw ewh
O, TF	o tf
UE, C	ue c
GBTA, RD	gbta rd
EJ, N	ej n
RP, LBEQ	rp lbeq
E, ALYFF	e alyff
HDLRRZ, E	hdlrrz e
Z, N	z n
Y, TU	y tu
U, ZCAIFJUN	u zcaifjun
JPED, VTIO	jped vtio
WIZDM, VKC	wizdm vkc
PEGZRCBX, O	pegzrcbx o
G, IU	g iu
O, L	o l
E, KJ	e kj
QB, D	qb d
I, REUNP	i reunp
SGZNDX, WU	sgzndx wu
L, EL	l el
A, JZNHV	a jznhv
VG, Q	vg q
Q, XDL	q xdl
NGTV, A	ngtv a
DT, X	dt x
IVJFUC, LUQVA	ivjfuc luqva
BK, NJ	bk nj
KSN, ZQ	ksn zq
C, MHUX	c mhux
T, XUMBHLK	t xumbhlk
UMYT, RFZRG	umyt rfzrg
E, DEC	e dec
C, TR	c tr
X, U	x u
D, KX	d kx
AT, BK	at bk
VA, MWP	va mwp
B, BENYWDRU	b benywdru
G, T	g t
LJ, TG	lj tg
BYPW, L	bypw l
E, W	e w
M, W	m w
U, UKHDL	u ukhdl
L, PLLC	l pllc
OVF, I	ovf i
Q, F	q f
SR, ZEXE	sr zexe
HJQ, NG	hjq ng
Z, B	z b
YN, PVG	yn pvg
Y, RIYM	y riym
D, V	d v
MZWRX, BC	mzwrx bc
Q, NPOG	q npog
YKDC, LCU	ykdc lcu
QY, F	qy f
HBELI, L	hbeli l
Y, T	y t
M, M	m m
CI, F	ci f
ECBMSPN, N	ecbmspn n
O, R	o r
YIEE, Z	yiee z
L, EB	l eb
B, FWN	b fwn
OHXAY, WUM	ohxay wum
YI, XANW	yi xanw
ZX, OC	zx oc
HYHJL, R	hyhjl r
SVWXWPFCZ, CYV	svwxwpfcz cyv
Y, VS	y vs
N, GK	n gk
E, EC	e ec
OU, FKHH	ou fkhh
CO, S	co s
O, WI	o wi
G, M	g m
AOAFSIAQWJ, LW	aoafsiaqwj lw
HZWNAO, CRR	hzwnao crr
H, BM	h bm
A, SNVHKBTO	a snvhkbto
VDT, LXUNI	vdt lxuni
FOI, HL	foi hl
S, E	s e
JGE, UIYW	jge uiyw
K, T	k t
HY, CJ	hy cj
REQE, A	reqe a
NFM, B	nfm b
YT, W	yt w
Z, HTK	z htk
XH, WD	xh wd
Y, WQ	y wq
VN, NN	vn nn
F, EMBO	f embo
XO, JQ	xo jq
QYFLT, KUGU	qyflt kugu
BVEJ, GH	bvej gh
J, JD	j jd
VI, A	vi a
IDQELO, EZBELXD	idqelo ezbelxd
W, IB	w ib
OBAXDA, C	obaxda c
RQR, DQ	rqr dq
DBY, B	dby b
NK, JF	nk jf
AZB, Y	azb y
BF, HN	bf hn
KMS, NN	kms nn
ALY, JKB	aly jkb
URE, E	ure e
A, WYN	a wyn
LY, EA	ly ea
VCDYC, LW	vcdyc lw
SM, VN	sm vn
D, Y	d y
I, W	i w
A, SOCA	a soca
I, C	i c
Z, A	z a
F, V	f v
VUKLSCW, W	vuklscw w
CFN, UH	cfn uh
YJFO, OV	yjfo ov
MT, LRV	mt lrv
NW, YAXT	nw yaxt
X, UPWVQ	x upwvq
WF, Z	wf z
OUETWP, P	ouetwp p
VE, FMR	ve fmr
QZ, S	qz s
Q, Z	q z
WZR, ANU	wzr anu
Q, SB	q sb
MEEGLUXH, BCLTQ	meegluxh bcltq
HLXF, FWQQQ	hlxf fwqqq
KDCMVR, Y	kdcmvr y
JZG, EB	jzg eb
Q, FO	q fo
G, Y	g y
N, DIZLHF	n dizlhf
R, L	r l
C, C	c c
TR, U	tr u
OH, YC	oh yc
R, L	r l
BSE, D	bse d
T, GP	t gp
MHFFK, IN	mhffk in
ZB, XTG	zb xtg
D, FGU	d fgu
RXELY, VOP	rxely vop
PNER, PU	pner pu
C, HTTC	c httc
LZ, Y	lz y
Y, X	y x
V, D	v d
KGJLX, RL	kgjlx rl
ABW, K	abw k
DU, F	du f
RJK, ZY	rjk zy
G, G	g g
E, AM	e am
PAZGQLT, RRM	pazgqlt rrm
QK, N	qk n
VYWTZ, K	vywtz k
L, Q	l q
SIZ, G	siz g
NW, FLERHJS	nw flerhjs
B, R	b r
OCO, NENVPY	oco nenvpy
E, I	e i
D, LCC	d lcc
UB, LNA	ub lna
VDM, HOZ	vdm hoz
CCT, CBMIWVJ	cct cbmiwvj
HQ, BTOIR	hq btoir
X, OZAJUTG	x ozajutg
HBTIU, T	hbtiu t
N, Z	n z
C, EQT	c eqt
A, L	a l
C, U	c u
RZCV, BWL	rzcv bwl
DAAF, IJOP	daaf ijop
N, K	n k
QRO, W	qro w
B, QVGMFL	b qvgmfl
UBE, DRKWOOCE	ube drkwooce
FH, HOY	fh hoy
FGS, K	fgs k
BI, MXU	bi mxu
SQSDN, O	sqsdn o
LVQPJPF, W	lvqpjpf w
RHZ, II	rhz ii
Z, S	z s
R, TB	r tb
EV, M	ev m
Y, BRSIRXCUMP	y brsirxcump
R, Y	r y
Q, ZM	q zm
YGU, NM	ygu nm
QQ, W	qq w
HHKBAX, Y	hhkbax y
C, QC	c qc
J, D	j d
PF, CU	pf cu
SPA, R	spa r
TR, B	tr b
A, TL	a tl
Q, K	q k
DN, CEQ	dn ceq
PSY, SKE	psy ske
W, I	w i
VZV, NU	vzv nu
KFB, I	kfb i
ZL, O	zl o
N, VF	n vf
L, FCEMA	l fcema
VDTPKWD, AG	vdtpkwd ag
T, C	t c
D, F	d f
GB, Z	gb z
SDX, VOC	sdx voc
AQYYC, H	aqyyc h
ALD, T	ald t
F, BU	f bu
MSCU, E	mscu e
J, P	j p
KZ, MPKO	kz mpko
W, PC	w pc
NY, U	ny u
TLUM, KW	tlum kw
XEB, O	xeb o
QU, HMW	qu hmw
KKG, NM	kkg nm
S, P	s p
SLD, A	sld a
N, LI	n li
TEJZK, DUEVSIO	tejzk duevsio
L, JNCNTYFWTM	l jncntyfwtm
U, K	u k
YU, Z	yu z
WUI, NWCBMFOCA	wui nwcbmfoca
G, DJIKY	g djiky
B, QLIAPO	b qliapo
ET, O	et o
T, YYR	t yyr
I, HGFN	i hgfn
QD, SC	qd sc
Y, R	y r
WTU, X	wtu x
UYQ, NDCX	uyq ndcx
DPVJ, E	dpvj e
THVP, Y	thvp y
RG, YS	rg ys
NAMHEF, MKFJ	namhef mkfj
L, IBG	l ibg
F, KFWJ	f kfwj
RVFAP, KIF	rvfap kif
B, JV	b jv
SD, QMWB	sd qmwb
OC, R	oc r
QCXIY, FJENSH	qcxiy fjensh
UF, HJM	uf hjm
T, JFMY	t jfmy
NN, UFX	nn ufx
R, XGYLH	r xgylh
M, GA	m ga
F, G	f g
T, CUTG	t cutg
M, BBQV	m bbqv
C, SXVEW	c sxvew
QN, Y	qn y
R, OJ	r oj
YSHMLHGU, SH	yshmlhgu sh
DQCGHXECERQN, W	dqcghxecerqn w
F, TJK	f tjk
W, BJQI	w bjqi
GDI, XZDL	gdi xzdl
E, Z	e z
O, FIFHY	o fifhy
Z, BKUX	z bkux
SLXLD, YW	slxld yw
BP, AKNCQ	bp akncq
JL, QP	jl qp
K, ILHI	k ilhi
GA, I	ga i
EY, OS	ey os
QL, YA	ql ya
ZHHJD, YL	zhhjd yl
O, LV	o lv
IDJ, Q	idj q
XMQPNDF, AZ	xmqpndf az
G, IE	g ie
UER, RD	uer rd
UUF, Z	uuf z
LT, X	lt x
K, UC	k uc
O, TBB	o tbb
J, AF	j af
L, EJOOJHI	l ejoojhi
H, HM	h hm
B, XW	b xw
B, TMN	b tmn
IM, Q	im q
NFDBRA, JJW	nfdbra jjw
JPO, CYOFCH	jpo cyofch
L, UXVK	l uxvk
DL, EH	dl eh
OCMZEJM, WFGR	ocmzejm wfgr
ULA, Z	ula z
J, LP	j lp
J, VCO	j vco
D, X	d x
IXZB, NYK	ixzb nyk
XXB, OJ	xxb oj
WVU, EW	wvu ew
SDF, AYDB	sdf aydb
AQ, TBUK	aq tbuk
XZ, DF	xz df
Z, PBA	z pba
MH, MQTL	mh mqtl
L, XH	l xh
BZ, RTKYJ	bz rtkyj
J, I	j i
IR, ZQ	ir zq
YA, JTDZ	ya jtdz
S, HG	s hg
TMKMU, PIT	tmkmu pit
R, VW	r vw
I, Z	i z
UJ, FWGB	uj fwgb
C, W	c w
MD, KJ	md kj
ZQ, A	zq a
Y, Z	y z
MVU, DI	mvu di
XLRFILE, O	xlrfile o
OI, HVMY	oi hvmy
HD, BEX	hd bex
Q, EGEJ	q egej
G, H	g h
DA, TA	da ta
VHJE, JBFEIG	vhje jbfeig
Y, YAU	y yau
UCINMU, E	ucinmu e
W, V	w v
X, NYSU	x nysu
PTFAOA, U	ptfaoa u
JUYA, EHR	juya ehr
LRZU, HJ	lrzu hj
U, L	u l
OZW, TV	ozw tv
BGHTYUVRV, X	bghtyuvrv x
V, PFXREC	v pfxrec
RQ, Z	rq z
HI, ZDS	hi zds
H, U	h u
DXG, TBR	dxg tbr
Z, FO	z fo
C, Y	c y
CZ, HQT	cz hqt
Z, IG	z ig
Q, TY	q ty
EB, I	eb i
A, A	a a
W, J	w j
X, FY	x fy
BAIA, TZR	baia tzr
CE, S	ce s
S, LEBI	s lebi
ER, BSO	er bso
EVQ, K	evq k
XLG, P	xlg p
EWY, V	ewy v
KV, TK	kv tk
B, Y	b y
B, OVJD	b ovjd
DB, GIVF	db givf
V, KNC	v knc
PK, O	pk o
HX, GDD	hx gdd
YP, LB	yp lb
I, AFRTAFC	i afrtafc
XXV, OTIH	xxv otih
S, PM	s pm
BL, Q	bl q
I, WF	i wf
J, X	j x
YPYTOB, CV	ypytob cv
UWUJDXVW, Z	uwujdxvw z
ZJK, I	zjk i
CG, IRCL	cg ircl
X, J	x j
UBA, IKEUT	uba ikeut
PRB, HI	prb hi
IJ, ZK	ij zk
QG, AVI	qg avi
BW, Q	bw q
DIO, SERTZD	dio sertzd
X, M	x m
D, N	d n
U, GJ	u gj
Z, OWRXZL	z owrxzl
C, K	c k
CTMKE, II	ctmke ii
HPO, BCE	hpo bce
AC, M	ac m
VKLO, DETRDMLZ	vklo detrdmlz
ZBO, LVZWYO	zbo lvzwyo
MO, X	mo x
AL, H	al h
AHVFFW, H	ahvffw h
YW, L	yw l
AJ, YOXLL	aj yoxll
I, PHG	i phg
MNP, X	mnp x
N, PD	n pd
OK, Q	ok q
DWXV, B	dwxv b
YIGNI, ZWZ	yigni zwz
G, X	g x
Y, O	y o
LWJE, M	lwje m
YAVG, J	yavg j
G, W	g w
KB, Q	kb q
ZGPWKM, OL	zgpwkm ol
R, NLY	r nly
IYV, ULL	iyv ull
RHA, WTWF	rha wtwf
V, CIIZ	v ciiz
V, YTEF	v ytef
X, ODDA	x odda
Q, GE	q ge
UIMC, D	uimc d
E, G	e g
DDRE, FDNCZ	ddre fdncz
O, R	o r
A, WJ	a wj
EUIYW, TR	euiyw tr
PMFD, MG	pmfd mg
LL, QC	ll qc
XV, WTL	xv wtl
VN, QL	vn ql
KNYJ, V	knyj v
IMSTAE, VW	imstae vw
T, CL	t cl
QL, R	ql r
E, LQ	e lq
AH, T	ah t
SVUKV, DPFNFF	svukv dpfnff
QZX, R	qzx r
SXMJQ, NAOBFF	sxmjq naobff
KD, X	kd x
I, EMQBFL	i emqbfl
M, SXFJ	m sxfj
L, K	l k
SZP, TO	szp to
D, XDNVYMG	d xdnvymg
QS, AT	qs at
A, C	a c
E, L	e l
C, QB	c qb
TFW, I	tfw i
V, DP	v dp
C, BJZ	c bjz
Q, FKRC	q fkrc
J, RM	j rm
YMRI, P	ymri p
PG, EUVNW	pg euvnw
OPON, NTDGAQT	opon ntdgaqt
UOHU, IR	uohu ir
UKB, V	ukb v
J, W	j w
V, GV	v gv
X, N	x n
A, BG	a bg
T, IR	t ir
ZFWEB, KNO	zfweb kno
A, K	a k
D, X	d x
VQEY, O	vqey o
Y, HVXKF	y hvxkf
Q, D	q d
QZR, XZKW	qzr xzkw
QID, AK	qid ak
KP, HMJYF	kp hmjyf
IRE, TUMYQA	ire tumyqa
U, S	u s
ENVPHNTOU, F	envphntou f
P, M	p m
I, Y	i y
NCP, WAXIS	ncp waxis
O, C	o c
QTPMS, P	qtpms p
T, UK	t uk
P, H	p h
G, ENET	g enet
D, ENOBF	d enobf
YWPNBOCH, JI	ywpnboch ji
FUG, RT	fug rt
HBZWGL, S	hbzwgl s
V, ZV	v zv
Q, KRMKS	q krmks
D, Y	d y
E, D	e d
B, CC	b cc
IUPC, NBME	iupc nbme
KA, RGRAF	ka rgraf
EZGW, TZUBM	ezgw tzubm
CTLJUGN, W	ctljugn w
PS, VRL	ps vrl
OXZ, TJOJ	oxz tjoj
TUHNHSXIS, FD	tuhnhsxis fd
P, INBJW	p inbjw
EMURY, N	emury n
UKI, BP	uki bp
EN, H	en h
BHT, VY	bht vy
DW, OUDH	dw oudh
SQ, MI	sq mi
WHMLW, H	whmlw h
TS, JHKI	ts jhki
G, QKFXVBY	g qkfxvby
VEN, I	ven i
AY, VBH	ay vbh
EJLZB, CFIG	ejlzb cfig
V, B	v b
G, ZACUV	g zacuv
T, U	t u
YY, Q	yy q
ZK, J	zk j
EIRQGUGG, EUK	eirqgugg euk
CLNT, D	clnt d
KC, M	kc m
ZUIXB, E	zuixb e
QB, U	qb u
IR, RVAB	ir rvab
DME, UWC	dme uwc
LN, SOE	ln soe
W, FSN	w fsn
OFZ, KE	ofz ke
DJ, FZ	dj fz
YR, VZJL	yr vzjl
IR, O	ir o
L, RKMVOA	l rkmvoa
VYM, TNZ	vym tnz
VFF, UF	vff uf
SA, V	sa v
B, LUQXY	b luqxy
DL, SW	dl sw
LXQ, IOU	lxq iou
E, A	e a
EOR, R	eor r
TYQNQKYWGQN, D	tyqnqkywgqn d
CRFJLUH, GY	crfjluh gy
BZ, YMT	bz ymt
UM, KF	um kf
I, G	i g
ZI, X	zi x
T, XQ	t xq
C, SVACRK	c svacrk
WN, Z	wn z
F, N	f n
F, AD	f ad
M, OTUISGE	m otuisge
Z, UNZE	z unze
RSJZ, DPM	rsjz dpm
SYF, GL	syf gl
BU, MEJDXQ	bu mejdxq
WGMW, J	wgmw j
WT, XD	wt xd
AD, XKK	ad xkk
UVJKYSJ, V	uvjkysj v
MM, EOJZGXQZG	mm eojzgxqzg
V, T	v t
GAFFGC, GAD	gaffgc gad
EF, F	ef f
V, SSN	v ssn
Q, M	q m
FHTR, DPMC	fhtr dpmc
BYNY, O	byny o
Y, JBVVQD	y jbvvqd
NV, M	nv m
G, CO	g co
S, BGFPUH	s bgfpuh
QTV, YNEQN	qtv yneqn
WMSXAD, FY	wmsxad fy
BNMQX, A	bnmqx a
LNB, Z	lnb z
DBOZBTLW, C	dbozbtlw c
K, CSP	k csp
Y, X	y x
GJEEF, A	gjeef a
A, PR	a pr
J, IDY	j idy
KBJ, X	kbj x
W, ZML	w zml
OEBIFJDD, OU	oebifjdd ou
LO, WJ	lo wj
ZWJNLUO, K	zwjnluo k
NMNY, SUEEXA	nmny sueexa
TO, KG	to kg
RZUBB, KMT	rzubb kmt
FK, KV	fk kv
PKSE, YM	pkse ym
W, IZ	w iz
Y, FF	y ff
I, BK	i bk
L, E	l e
M, HHK	m hhk
BWQH, EJX	bwqh ejx
A, BA	a ba
YZ, EXWXZC	yz exwxzc
B, GDTX	b gdtx
K, ZKUETVN	k zkuetvn
GF, R	gf r
F, FPPKBSOSB	f fppkbsosb
ICNXQV, YSW	icnxqv ysw
FB, SH	fb sh
WD, I	wd i
RQF, WW	rqf ww
DCBO, S	dcbo s
YZZVV, ZZ	yzzvv zz
X, PWO	x pwo
N, VF	n vf
WN, XOX	wn xox
TDOTWXOE, YFUX	tdotwxoe yfux
B, M	b m
SC, J	sc j
EUQIRWA, Y	euqirwa y
DOOOPKCQ, AHOLVNV	dooopkcq aholvnv
MF, VLKAWPA	mf vlkawpa
LBIP, PB	lbip pb
C, JRJ	c jrj
L, GL	l gl
VEB, UZGF	veb uzgf
UM, CZ	um cz
WQ, T	wq t
PG, CV	pg cv
TWRUO, W	twruo w
OMYC, O	omyc o
VPO, BFML	vpo bfml
J, EC	j ec
CVJAKFPQDD, OIZ	cvjakfpqdd oiz
TZM, VR	tzm vr
F, FZ	f fz
Q, YIB	q yib
HE, Z	he z
C, ZR	c zr
Q, RH	q rh
CE, Y	ce y
UB, W	ub w
TH, W	th w
X, A	x a
EHXRHLHY, NMYATE	ehxrhlhy nmyate
X, F	x f
Y, SL	y sl
L, IH	l ih
PGME, AV	pgme av
NGC, IFQ	ngc ifq
I, E	i e
CLWS, B	clws b
Y, S	y s
Q, O	q o
TQ, PC	tq pc
QJP, W	qjp w
M, PIBGE	m pibge
D, HERAX	d herax
N, A	n a
S, LMGGMY	s lmggmy
QX, YB	qx yb
R, T	r t
FC, XI	fc xi
MD, MB	md mb
P, T	p t
VK, KK	vk kk
KAO, OF	kao of
A, IB	a ib
CCLT, BZN	cclt bzn
I, Z	i z
JGFZ, P	jgfz p
HKMXWCE, KK	hkmxwce kk
M, L	m l
T, EL	t el
Q, F	q f
KJNL, NRXJ	kjnl nrxj
F, YUXKRKKDDNH	f yuxkrkkddnh
X, VFIY	x vfiy
NN, WY	nn wy
YE, E	ye e
XQW, W	xqw w
HQ, SF	hq sf
IE, P	ie p
D, TS	d ts
P, GJ	p gj
OSPTKMTSP, KRV	osptkmtsp krv
BU, CRJ	bu crj
YCGX, ATPKG	ycgx atpkg
X, E	x e
XV, UW	xv uw
HPX, C	hpx c
Z, Q	z q
C, CP	c cp
Q, M	q m
Q, IA	q ia
F, SXCCO	f sxcco
QBYXLNZM, REPJI	qbyxlnzm repji
XG, IUC	xg iuc
P, V	p v
MAN, QC	man qc
P, VFAMDH	p vfamdh
V, TOQU	v toqu
D, S	d s
SEBFZBUYR, TTS	sebfzbuyr tts
TGQLH, WX	tgqlh wx
KUK, PXUQFG	kuk pxuqfg
IV, Z	iv z
G, F	g f
GIBL, PPPJ	gibl pppj
FJDZTIJD, EDNWFA	fjdztijd ednwfa
DG, DO	dg do
KKQZZHD, B	kkqzzhd b
ZL, V	zl v
KKKVVO, AE	kkkvvo ae
UNXURQKO, Y	unxurqko y
X, AA	x aa
LE, IGJN	le igjn
Q, ANPTT	q anptt
AM, I	am i
HR, RP	hr rp
HZHPMA, OHAT	hzhpma ohat
O, LYNWX	o lynwx
CD, AEXM	cd aexm
YX, QMC	yx qmc
Y, TXMT	y txmt
YRG, Q	yrg q
VWDU, TFXOXAV	vwdu tfxoxav
NE, GVG	ne gvg
K, QVP	k qvp
KNSG, TV	knsg tv
OBJISMQ, B	objismq b
NWSEU, IZR	nwseu izr
NQAY, DKKHK	nqay dkkhk
TJ, QNUI	tj qnui
I, R	i r
L, T	l t
A, NDHNPXU	a ndhnpxu
UGLGTYXX, FN	uglgtyxx fn
IMCU, D	imcu d
UV, WKL	uv wkl
TJLPCE, H	tjlpce h
G, UUJL	g uujl
D, PSNY	d psny
HT, NIN	ht nin
MMZ, P	mmz p
OOCQ, CS	oocq cs
WP, S	wp s
D, W	d w
GHA, FIAJZ	gha fiajz
T, J	t j
SCET, C	scet c
NZ, T	nz t
NH, EB	nh eb
Y, IP	y ip
CDPZ, DYCVUOC	cdpz dycvuoc
I, HFL	i hfl
DJEG, GP	djeg gp
VQMHY, U	vqmhy u
M, RCR	m rcr
E, L	e l
LLRIG, R	llrig r
E, U	e u
BX, EV	bx ev
ZVG, IZGN	zvg izgn
V, PMXPIQUCKETTFFP	v pmxpiquckettffp
F, NF	f nf
D, CLP	d clp
PN, A	pn a
QDI, PW	qdi pw
BTA, U	bta u
IZ, RQ	iz rq
TQH, XCRCIHQQW	tqh xcrcihqqw
V, M	v m
FX, U	fx u
HMHBB, OS	hmhbb os
AK, CUAABAQ	ak cuaabaq
M, IPVGE	m ipvge
WJQFRCXL, B	wjqfrcxl b
RX, U	rx u
LU, YB	lu yb
C, J	c j
YMMSP, S	ymmsp s
M, RBY	m rby
GJ, XVK	gj xvk
BJ, Z	bj z
CTQ, DOZQNM	ctq dozqnm
F, PW	f pw
XI, VRSR	xi vrsr
W, D	w d
GB, DX	gb dx
D, C	d c
BNGIINTMKB, E	bngiintmkb e
FHQZMHI, V	fhqzmhi v
YAVT, Z	yavt z
T, DQA	t dqa
Q, FX	q fx
QNZW, J	qnzw j
NNG, QHB	nng qhb
FE, MAWU	fe mawu
XLMBJ, T	xlmbj t
ZC, H	zc h
QMJR, QKJ	qmjr qkj
S, Y	s y
I, YTEJSAT	i ytejsat
V, NI	v ni
Z, P	z p
JW, PJ	jw pj
B, APC	b apc
J, D	j d
BRTDJA, CI	brtdja ci
L, V	l v
DQZNVKYOKRG, KN	dqznvkyokrg kn
PGZZV, BZ	pgzzv bz
Z, I	z i
H, Y	h y
U, U	u u
FNWCH, SOFA	fnwch sofa
M, T	m t
UYEEMEA, F	uyeemea f
AN, YFD	an yfd
GH, ME	gh me
Q, U	q u
O, CJULUKRO	o cjulukro
Y, I	y i
U, OIXZTR	u oixztr
P, BKI	p bki
CY, YDDY	cy yddy
WA, GZQLRA	wa gzqlra
ISG, K	isg k
L, FZ	l fz
HU, EIMLW	hu eimlw
PX, FQ	px fq
UWI, L	uwi l
Q, UEP	q uep
GUYAU, GUUN	guyau guun
K, QB	k qb
Z, A	z a
UGQRH, S	ugqrh s
TS, YZDL	ts yzdl
Y, JTZ	y jtz
WXCU, SNTH	wxcu snth
NBSFC, AO	nbsfc ao
U, HVZ	u hvz
RDY, F	rdy f
I, WS	i ws
Y, EO	y eo
CQG, Z	cqg z
IO, WJ	io wj
NRCP, AL	nrcp al
THT, YR	tht yr
Q, WXV	q wxv
LBLPD, Y	lblpd y
YBYV, QKEM	ybyv qkem
NHEQFD, MJIYSGS	nheqfd mjiysgs
ZP, GX	zp gx
K, W	k w
OSV, D	osv d
F, EZP	f ezp
R, I	r i
D, M	d m
SQA, KU	sqa ku
WIVDTDO, PE	wivdtdo pe
GC, DROEX	gc droex
V, B	v b
POP, R	pop r
ZW, VAZ	zw vaz
VSJA, WW	vsja ww
JK, Z	jk z
EB, YU	eb yu
PHHMXNWZNPNPNYW, PRTA	phhmxnwznpnpnyw prta
E, W	e w
B, D	b d
TYM, I	tym i
XPEQ, EI	xpeq ei
BYU, MB	byu mb
VGK, P	vgk p
WO, CWJ	wo cwj
MWJJQ, BNU	mwjjq bnu
KJ, VIJ	kj vij
M, NLEXNG	m nlexng
B, V	b v
FG, TK	fg tk
R, J	r j
GPTK, Z	gptk z
J, X	j x
XEBO, DVF	xebo dvf
CS, UDDBLCBXY	cs uddblcbxy
TXJT, A	txjt a
SFBZE, BSMRTJ	sfbze bsmrtj
KH, VG	kh vg
B, MPVT	b mpvt
E, Q	e q
YJRFSCY, CL	yjrfscy cl
U, BXKV	u bxkv
T, TT	t tt
C, G	c g
K, QR	k qr
FBN, A	fbn a
HVIVDQ, TTY	hvivdq tty
NP, ZYSH	np zysh
GP, V	gp v
E, X	e x
S, Z	s z
F, V	f v
WRN, Q	wrn q
NACG, N	nacg n
OD, AYKH	od aykh
SB, WJ	sb wj
T, Z	t z
UR, ZX	ur zx
O, G	o g
VX, PQGD	vx pqgd
F, WBUK	f wbuk
ID, R	id r
B, N	b n
XU, RDSIM	xu rdsim
KQWRNITBX, A	kqwrnitbx a
AI, R	ai r
OJHGP, GH	ojhgp gh
QH, PBGOWU	qh pbgowu
K, D	k d
NDE, AG	nde ag
P, GN	p gn
BHUQ, FJQX	bhuq fjqx
XZAL, KQMFCB	xzal kqmfcb
T, V	t v
K, ZLQ	k zlq
KCT, L	kct l
GX, VV	gx vv
R, LDB	r ldb
S, VQEF	s vqef
RZA, RH	rza rh
EP, B	ep b
CO, L	co l
J, XPE	j xpe
T, G	t g
WD, F	wd f
USJ, IWI	usj iwi
EW, J	ew j
J, GG	j gg
TX, GFU	tx gfu
M, K	m k
X, FHG	x fhg
SCT, V	sct v
UR, F	ur f
K, E	k e
QDY, HBQIL	qdy hbqil
PQ, KIJ	pq kij
VVY, V	vvy v
YYICJ, X	yyicj x
V, Z	v z
TYV, L	tyv l
S, UAGKR	s uagkr
X, LZDW	x lzdw
H, EQWJ	h eqwj
SRJI, NQIFP	srji nqifp
O, SZD	o szd
R, XCRLD	r xcrld
SW, S	sw s
CPJP, LB	cpjp lb
UJ, MAY	uj may
HMW, KC	hmw kc
BDF, G	bdf g
E, E	e e
R, EKRF	r ekrf
T, A	t a
V, VKPMRZSES	v vkpmrzses
TCW, T	tcw t
XPS, RKVSAT	xps rkvsat
D, WR	d wr
NEYC, K	neyc k
Q, ED	q ed
DAXG, HDKM	daxg hdkm
GL, AQ	gl aq
HAWVJ, U	hawvj u
VU, B	vu b
CN, X	cn x
L, E	l e
Z, DXG	z dxg
DK, HRJVCKIZ	dk hrjvckiz
JIHO, G	jiho g
W, Y	w y
F, Y	f y
EU, LE	eu le
DW, VD	dw vd
SFOL, SGEJEZR	sfol sgejezr
X, F	x f
JZS, W	jzs w
MK, EG	mk eg
RDKV, XCCGMG	rdkv xccgmg
L, FTD	l ftd
EINWD, NBY	einwd nby
KW, KV	kw kv
U, AR	u ar
R, WCAQP	r wcaqp
AF, H	af h
XM, Q	xm q
V, ESW	v esw
HHZT, PH	hhzt ph
Y, MUVJG	y muvjg
KBCB, MLI	kbcb mli
Q, HCO	q hco
E, Z	e z
P, OJQMRQ	p ojqmrq
GL, O	gl o
BKSZ, R	bksz r
Z, FWC	z fwc
QOJK, AE	qojk ae
VW, G	vw g
OY, CQU	oy cqu
Y, CD	y cd
RLL, TVW	rll tvw
XFA, R	xfa r
O, Q	o q
M, OQALHLNL	m oqalhlnl
MZRPL, DCB	mzrpl dcb
LNHUEYDM, WC	lnhueydm wc
MAEWCTKHAHWX, OU	maewctkhahwx ou
VPFT, HG	vpft hg
I, DK	i dk
D, XQZ	d xqz
HM, ZN	hm zn
QQCT, A	qqct a
W, KO	w ko
HX, BFI	hx bfi
ZRR, N	zrr n
VPZ, X	vpz x
ZID, OWFFX	zid owffx
Q, HG	q hg
S, ME	s me
ULJKMMOCKBYE, GREQC	uljkmmockbye greqc
T, D	t d
OPYGDM, TJ	opygdm tj
SBL, OUT	sbl out
T, D	t d
OY, J	oy j
OIRWORRUT, F	oirworrut f
OUCII, JJT	oucii jjt
LXW, QJ	lxw qj
IL, HOJFR	il hojfr
IP, AIGTZRWRF	ip aigtzrwrf
SDX, HR	sdx hr
XOW, O	xow o
F, KI	f ki
B, H	b h
V, PVRC	v pvrc
J, RA	j ra
KFJLNRCJ, FYR	kfjlnrcj fyr
T, NAGB	t nagb
P, K	p k
D, CPS	d cps
F, EW	f ew
JMF, B	jmf b
PSUOIU, NLN	psuoiu nln
Y, N	y n
PVOW, H	pvow h
FX, RG	fx rg
TJL, WZWLO	tjl wzwlo
WTK, Z	wtk z
R, XE	r xe
KNLS, C	knls c
AE, R	ae r
GIC, L	gic l
RX, L	rx l
D, F	d f
A, FWQ	a fwq
Z, LWE	z lwe
RL, CQ	rl cq
JOZSCUMQ, TP	jozscumq tp
R, A	r a
L, A	l a
UEK, R	uek r
G, D	g d
HJCJ, A	hjcj a
W, G	w g
FQ, Q	fq q
VVYQMVZIORGU, P	vvyqmvziorgu p
B, N	b n
C, H	c h
J, GMG	j gmg
P, S	p s
GES, GX	ges gx
S, A	s a
S, YN	s yn
D, M	d m
ONT, VLZEMRYY	ont vlzemryy
XPN, J	xpn j
MBCE, KE	mbce ke
JUXQHX, FQ	juxqhx fq
LLAL, D	llal d
ZOV, W	zov w
Q, P	q p
K, XPXW	k xpxw
UV, ECI	uv eci
QF, A	qf a
KCV, HBVUGH	kcv hbvugh
N, XWZAJOIP	n xwzajoip
UWEGNF, DF	uwegnf df
C, Z	c z
JXG, O	jxg o
VGQ, WZ	vgq wz
X, K	x k
XGK, CDY	xgk cdy
K, O	k o
SK, RU	sk ru
OUHDS, ZH	ouhds zh
ATXIT, LIWC	atxit liwc
KED, TOXF	ked toxf
U, TE	u te
TEI, OTJ	tei otj
P, X	p x
OC, P	oc p
C, V	c v
PD, XHKV	pd xhkv
BP, ZAL	bp zal
S, WI	s wi
C, A	c a
ENIXRO, ZKVSFS	enixro zkvsfs
SVB, S	svb s
I, TW	i tw
R, V	r v
P, RLJ	p rlj
IRU, E	iru e
AE, WOM	ae wom
FY, GFS	fy gfs
CSOEC, S	csoec s
GKOJSLZ, V	gkojslz v
L, YK	l yk
DPVP, U	dpvp u
B, D	b d
QX, YT	qx yt
E, G	e g
F, ADPG	f adpg
QN, DXI	qn dxi
MV, C	mv c
XA, ZMNH	xa zmnh
GML, Q	gml q
FSJVASUTK, AM	fsjvasutk am
K, O	k o
J, LQ	j lq
NA, D	na d
ZDOOQNZT, V	zdooqnzt v
D, MN	d mn
Q, K	q k
Y, P	y p
UQMK, M	uqmk m
UXZAU, WCB	uxzau wcb
R, ILM	r ilm
V, KI	v ki
SKGKOVLTCHAEQX, MCA	skgkovltchaeqx mca
R, CX	r cx
KKOML, G	kkoml g
RXBR, LAA	rxbr laa
GQIO, YJ	gqio yj
D, RW	d rw
I, JR	i jr
O, QDCI	o qdci
KRZZU, WWRX	krzzu wwrx
CNU, ACZ	cnu acz
X, EVY	x evy
YGJ, YKMKB	ygj ykmkb
LZ, I	lz i
U, C	u c
ZB, NZDR	zb nzdr
GOTIQFM, M	gotiqfm m
XC, K	xc k
H, S	h s
C, IY	c iy
Q, RWM	q rwm
H, Q	h q
BI, EF	bi ef
OKEXDU, P	okexdu p
E, E	e e
PZ, VQCY	pz vqcy
TC, B	tc b
OP, FE	op fe
ZT, EWP	zt ewp
D, R	d r
C, MC	c mc
AE, GBFFBNVEL	ae gbffbnvel
X, ZI	x zi
J, CS	j cs
WERZB, H	werzb h
X, BS	x bs
C, ZVE	c zve
YQAISK, DT	yqaisk dt
D, FKUP	d fkup
LXIVA, Z	lxiva z
FY, BFJ	fy bfj
KOY, T	koy t
N, P	n p
J, GZ	j gz
SP, XKQR	sp xkqr
HFE, ZKDQ	hfe zkdq
LIMRD, OINJ	limrd oinj
XSTHFVNK, I	xsthfvnk i
TH, LO	th lo
M, IFZ	m ifz
FL, N	fl n
MI, ZS	mi zs
Y, U	y u
D, BO	d bo
X, C	x c
BVMY, C	bvmy c
M, JB	m jb
CCMUCE, PV	ccmuce pv
TZHMPHRDPO, OPSZUV	tzhmphrdpo opszuv
Q, OATAZ	q oataz
QDA, PM	qda pm
E, GCGZGAJ	e gcgzgaj
YGWDXO, EZX	ygwdxo ezx
H, PRJHOBFN	h prjhobfn
R, FY	r fy
VC, IOJC	vc iojc
SRX, HGA	srx hga
WXX, WS	wxx ws
NZ, GLE	nz gle
TU, M	tu m
PZ, OKOEGP	pz okoegp
WP, LWGG	wp lwgg
C, ICQ	c icq
H, H	h h
T, TXV	t txv
Y, RON	y ron
F, IPQC	f ipqc
S, AXB	s axb
OO, V	oo v
W, KGT	w kgt
D, BE	d be
I, SPSG	i spsg
BH, AW	bh aw
CZDC, YI	czdc yi
Y, BH	y bh
LADH, YR	ladh yr
H, PMN	h pmn
UHZR, R	uhzr r
WKXZY, RSCH	wkxzy rsch
YR, MI	yr mi
DW, UYM	dw uym
X, C	x c
SNDBJZ, L	sndbjz l
B, RB	b rb
BCD, A	bcd a
F, Z	f z
KXZO, FAM	kxzo fam
O, QZ	o qz
BDMAML, IGX	bdmaml igx
S, KH	s kh
P, EI	p ei
B, V	b v
MC, D	mc d
GI, J	gi j
HHUT, N	hhut n
RMDUIWTAEUMW, K	rmduiwtaeumw k
Y, RML	y rml
JU, QD	ju qd
Y, Z	y z
N, QG	n qg
S, D	s d
ESOBU, FUGYG	esobu fugyg
IPXV, XR	ipxv xr
V, Y	v y
HMXA, L	hmxa l
DR, MOTFE	dr motfe
BMD, WR	bmd wr
RGSMMWP, SGSAR	rgsmmwp sgsar
CNA, NDR	cna ndr
N, GCKXC	n gckxc
RZ, X	rz x
B, BP	b bp
XOWWJ, NI	xowwj ni
ESP, YAMHGIIEI	esp yamhgiiei
FD, I	fd i
UW, SDRLTVST	uw sdrltvst
E, E	e e
K, JBJR	k jbjr
NBOFB, XS	nbofb xs
C, F	c f
O, JBUZ	o jbuz
U, E	u e
VQR, EO	vqr eo
FRZ, HO	frz ho
JD, SXIOOQ	jd sxiooq
KX, YUURYXN	kx yuuryxn
X, A	x a
XWJ, TUT	xwj tut
II, EJF	ii ejf
Y, JP	y jp
FX, F	fx f
FWFU, XO	fwfu xo
PO, J	po j
CTRH, JEX	ctrh jex
NZP, FF	nzp ff
C, O	c o
J, DD	j dd
EY, C	ey c
UZIKP, LMJ	uzikp lmj
AU, O	au o
TG, GYJA	tg gyja
FY, KHRSS	fy khrss
NEPGIO, N	nepgio n
HZY, KSF	hzy ksf
JZ, P	jz p
X, YPUY	x ypuy
MRCFAK, RI	mrcfak ri
TFAB, KPPIL	tfab kppil
FXZ, LL	fxz ll
YTPFA, NJG	ytpfa njg
M, NSQOZ	m nsqoz
LO, N	lo n
F, IZ	f iz
VYCO, H	vyco h
CISTUXX, M	cistuxx m
OFBGC, K	ofbgc k
X, JSWBPJSO	x jswbpjso
H, M	h m
T, LA	t la
R, JW	r jw
F, H	f h
N, ZCO	n zco
WTQU, M	wtqu m
TS, MMT	ts mmt
U, JI	u ji
VV, T	vv t
E, KGXDM	e kgxdm
KHLOIA, F	khloia f
P, RZ	p rz
YG, MROUPL	yg mroupl
TIP, GFIQ	tip gfiq
E, B	e b
A, M	a m
PHJ, S	phj s
PHPE, QBX	phpe qbx
T, M	t m
GTH, D	gth d
M, ZHQ	m zhq
CXRLCTIV, DB	cxrlctiv db
QQ, MWBY	qq mwby
Y, P	y p
R, PL	r pl
LD, I	ld i
AAEN, TJ	aaen tj
PWFWNDINYRRJEML, JY	pwfwndinyrrjeml jy
YLOK, DKS	ylok dks
L, L	l l
EUA, LMSL	eua lmsl
QH, DJK	qh djk
HU, P	hu p
RYZC, IY	ryzc iy
EBNF, J	ebnf j
VSW, HMIH	vsw hmih
TK, ZL	tk zl
Y, ECRJ	y ecrj
S, Z	s z
MRWKZ, N	mrwkz n
UXY, U	uxy u
V, BMXQR	v bmxqr
F, XJC	f xjc
BGS, VWNN	bgs vwnn
AHJGGL, QG	ahjggl qg
SVFWKWMD, US	svfwkwmd us
NJNF, RSKK	njnf rskk
B, OR	b or
Y, ZPEFWBXU	y zpefwbxu
GALIXF, PQMH	galixf pqmh
UIKQCLX, MJZNT	uikqclx mjznt
NER, ZR	ner zr
CQZ, PH	cqz ph
A, FORV	a forv
XRJ, NXJ	xrj nxj
O, M	o m
YG, M	yg m
AGS, ZKRT	ags zkrt
CO, O	co o
S, S	s s
O, EI	o ei
I, GO	i go
FTL, QRQTEIE	ftl qrqteie
T, MS	t ms
K, RK	k rk
F, I	f i
J, H	j h
I, M	i m
WNAISABXOT, L	wnaisabxot l
P, C	p c
LZR, Y	lzr y
XCW, TGQM	xcw tgqm
MI, N	mi n
GNGNJSERH, DC	gngnjserh dc
PF, Q	pf q
O, Z	o z
I, G	i g
PCESE, ZRDTOY	pcese zrdtoy
PZ, ZWP	pz zwp
NH, M	nh m
SUP, AY	sup ay
C, Q	c q
OWU, V	owu v
AD, I	ad i
KXM, JKD	kxm jkd
WD, M	wd m
K, YUPR	k yupr
S, R	s r
O, RZAUBB	o rzaubb
U, O	u o
CBV, EP	cbv ep
X, RZ	x rz
XJ, VYKAF	xj vykaf
SX, G	sx g
TO, TSI	to tsi
FUY, W	fuy w
GWI, D	gwi d
Q, EL	q el
HUDLGYE, F	hudlgye f
LD, JS	ld js
KK, H	kk h
CZ, J	cz j
W, FM	w fm
DWELM, O	dwelm o
LP, HVR	lp hvr
CA, WGK	ca wgk
Y, A	y a
DRNA, FR	drna fr
IYEUP, Q	iyeup q
ZITHF, KPE	zithf kpe
HYCIC, JRVAGGF	hycic jrvaggf
JVILEVN, PQ	jvilevn pq
SFT, SP	sft sp
JXW, H	jxw h
XR, AVIHPJV	xr avihpjv
OBOJOC, MW	obojoc mw
QLVPRM, O	qlvprm o
J, XXPB	j xxpb
A, DZTCTPML	a dztctpml
QIK, VN	qik vn
ROK, D	rok d
UHB, TSP	uhb tsp
W, E	w e
DKU, X	dku x
X, TE	x te
G, G	g g
RMJFF, IG	rmjff ig
Q, YRW	q yrw
I, ZX	i zx
N, I	n i
M, G	m g
XN, CVL	xn cvl
V, NMJWV	v nmjwv
XZ, XE	xz xe
L, H	l h
PEF, LV	pef lv
XRJ, K	xrj k
RNCB, P	rncb p
MOY, CXY	moy cxy
LIQKZK, FKJR	liqkzk fkjr
Z, L	z l
WW, L	ww l
N, L	n l
WN, FSPG	wn fspg
TXYV, CP	txyv cp
P, L	p l
T, VDJOQ	t vdjoq
TCZDOU, WUVI	tczdou wuvi
WVAPP, TJPX	wvapp tjpx
UG, XH	ug xh
BWF, T	bwf t
TYN, R	tyn r
MP, Z	mp z
Q, F	q f
LG, L	lg l
T, GFE	t gfe
INLGY, U	inlgy u
E, H	e h
F, U	f u
D, H	d h
WZZ, ZKH	wzz zkh
XLEZ, L	xlez l
F, W	f w
MKIKXV, CONU	mkikxv conu
HO, STS	ho sts
LV, H	lv h
RQ, DG	rq dg
CYSRERVZSZXWB, AONB	cysrervzszxwb aonb
FMHLOVM, BM	fmhlovm bm
SA, TDEK	sa tdek
K, FO	k fo
T, R	t r
BQPH, MSGHXB	bqph msghxb
NYO, II	nyo ii
WNC, OV	wnc ov
BXOK, XJ	bxok xj
S, NM	s nm
OMFQO, U	omfqo u
SN, EIW	sn eiw
FNYPL, S	fnypl s
QB, N	qb n
HZXXMZV, D	hzxxmzv d
M, I	m i
TKN, EWR	tkn ewr
LLK, J	llk j
U, STQ	u stq
GQVC, BV	gqvc bv
RM, ZDAY	rm zday
XXT, EFOY	xxt efoy
NKF, TM	nkf tm
BIG, DLV	big dlv
A, VAJE	a vaje
AT, LKR	at lkr
OEB, DEHR	oeb dehr
UUD, YLAJWH	uud ylajwh
ZRNFXQ, C	zrnfxq c
O, MH	o mh
PJ, QYINJJ	pj qyinjj
B, WJDB	b wjdb
HJ, DS	hj ds
P, WBODC	p wbodc
V, W	v w
Z, F	z f
O, WXNFH	o wxnfh
JCY, IMX	jcy imx
I, X	i x
W, F	w f
PYDX, TQIXN	pydx tqixn
H, UWIQ	h uwiq
B, UQJ	b uqj
LOYXMZQYG, KBRG	loyxmzqyg kbrg
ZDH, RSS	zdh rss
FC, MI	fc mi
W, Y	w y
J, HXKKSB	j hxkksb
M, YF	m yf
AO, Q	ao q
BLT, AJ	blt aj
H, Y	h y
U, H	u h
MHQ, HD	mhq hd
SX, XU	sx xu
XLBPZHI, WBL	xlbpzhi wbl
PCJ, N	pcj n
N, TIG	n tig
YH, F	yh f
M, EIVPJP	m eivpjp
N, HIMTTN	n himttn
PIX, HW	pix hw
VH, XAPIUULEE	vh xapiuulee
Z, HZSKFA	z hzskfa
PB, A	pb a
V, SUBK	v subk
YC, TNUAQRVQO	yc tnuaqrvqo
GIWS, W	giws w
CP, RQ	cp rq
RIQ, DUI	riq dui
R, A	r a
L, YXC	l yxc
Z, UCE	z uce
R, VDC	r vdc
ALC, G	alc g
X, TWVE	x twve
Q, UXJ	q uxj
DBHIJ, RXK	dbhij rxk
WQASZ, TJM	wqasz tjm
NP, FAR	np far
O, AR	o ar
L, C	l c
TLIF, XOAI	tlif xoai
U, IIHA	u iiha
L, X	l x
Z, HTFR	z htfr
D, T	d t
B, K	b k
I, AMY	i amy
YF, KO	yf ko
JHBB, JC	jhbb jc
H, DD	h dd
G, L	g l
JFJW, AI	jfjw ai
UJFKKLGWIJVJ, FR	ujfkklgwijvj fr
AITH, G	aith g
TSYOIF, DL	tsyoif dl
AK, J	ak j
GZSL, FN	gzsl fn
OJ, WXDMHX	oj wxdmhx
EIS, H	eis h
DURE, IZD	dure izd
K, IH	k ih
V, TLRMP	v tlrmp
SLUT, VC	slut vc
CMRUV, JGX	cmruv jgx
HD, G	hd g
V, AKE	v ake
ZLQ, EIS	zlq eis
T, CALGM	t calgm
GFZT, XVI	gfzt xvi
E, IHISX	e ihisx
SPRKQ, X	sprkq x
KD, LV	kd lv
Q, ZPBTXSZSFU	q zpbtxszsfu
Z, V	z v
B, PYPDMKF	b pypdmkf
F, OG	f og
WGEEL, Z	wgeel z
AR, DS	ar ds
Q, I	q i
EO, F	eo f
I, ZD	i zd
VI, CM	vi cm
KMFO, S	kmfo s
I, TSV	i tsv
O, FMX	o fmx
TLUI, WUPY	tlui wupy
Q, G	q g
P, TE	p te
Y, KDERQT	y kderqt
EHH, VWLF	ehh vwlf
JFSX, NLOBA	jfsx nloba
R, WIY	r wiy
E, R	e r
S, AIVV	s aivv
DWGTJZG, RFUL	dwgtjzg rful
D, U	d u
NMN, S	nmn s
OEH, IE	oeh ie
KQPJ, M	kqpj m
VSZ, V	vsz v
PWA, FG	pwa fg
M, G	m g
Y, TT	y tt
DUQ, D	duq d
RJW, MPZZF	rjw mpzzf
D, G	d g
BWV, UGVNHNHCA	bwv ugvnhnhca
OMIJ, JTL	omij jtl
X, W	x w
QEP, V	qep v
DLF, B	dlf b
N, Q	n q
VYV, R	vyv r
V, Y	v y
SHVKYY, L	shvkyy l
WGMBHBWREQ, A	wgmbhbwreq a
IKZYIM, GAU	ikzyim gau
LBL, SWCUVZ	lbl swcuvz
I, BJ	i bj
U, PZ	u pz
X, Q	x q
TZYAL, X	tzyal x
HV, LT	hv lt
PB, HGNEP	pb hgnep
CDRQ, C	cdrq c
B, RCCEGSWV	b rccegswv
LUBJ, Y	lubj y
S, PM	s pm
RFAZ, M	rfaz m
ZUJIWV, F	zujiwv f
F, T	f t
SGVNM, N	sgvnm n
KSVCAP, AFC	ksvcap afc
NAW, WU	naw wu
XGA, ILYEOEOX	xga ilyeoeox
KPQ, J	kpq j
SG, WCQHB	sg wcqhb
B, XC	b xc
P, N	p n
W, FLWHW	w flwhw
DXUXG, JI	dxuxg ji
OI, PRH	oi prh
IC, K	ic k
SCR, XQTKD	scr xqtkd
BZ, Q	bz q
GA, TN	ga tn
T, P	t p
YQZ, ML	yqz ml
JREUT, L	jreut l
QGQB, W	qgqb w
J, UTF	j utf
IJ, B	ij b
W, OG	w og
IUXXUE, NJ	iuxxue nj
JIPPX, DPQ	jippx dpq
MVU, NFERTYU	mvu nfertyu
X, X	x x
M, K	m k
MXNCL, QE	mxncl qe
H, Q	h q
JEL, K	jel k
N, AJGT	n ajgt
JM, RFEDD	jm rfedd
K, GW	k gw
N, TBSN	n tbsn
QAL, U	qal u
HOUPT, C	houpt c
QQYL, RE	qqyl re
I, GMMET	i gmmet
A, FWQ	a fwq
UDEW, Q	udew q
EV, LO	ev lo
A, YEKQ	a yekq
CX, WUB	cx wub
KM, P	km p
E, J	e j
PY, AVKV	py avkv
P, UXED	p uxed
L, DN	l dn
B, O	b o
O, QXG	o qxg
UEWQWBTWUKC, U	uewqwbtwukc u
J, ZJW	j zjw
WS, LUNXF	ws lunxf
E, L	e l
PY, V	py v
JSVCC, F	jsvcc f
M, RW	m rw
B, MLPVUV	b mlpvuv
YP, G	yp g
UMMHBT, F	ummhbt f
QIMV, YMW	qimv ymw
C, A	c a
XGAT, EO	xgat eo
PKT, L	pkt l
C, H	c h
QJ, DFJYUEDMJ	qj dfjyuedmj
H, W	h w
J, ST	j st
H, Z	h z
PB, K	pb k
Y, QRYFEALXPT	y qryfealxpt
ZI, A	zi a
E, XP	e xp
WNYT, H	wnyt h
MR, QQWULV	mr qqwulv
MUWIPVUQQXW, DF	muwipvuqqxw df
VZ, GFL	vz gfl
EL, QZUYODCDP	el qzuyodcdp
U, LVD	u lvd
U, NB	u nb
M, MSXXEQBV	m msxxeqbv
S, RAWB	s rawb
X, HREGGP	x hreggp
FS, LBDJ	fs lbdj
D, OK	d ok
Y, C	y c
PFP, C	pfp c
VV, A	vv a
JBA, Z	jba z
PC, QLA	pc qla
Z, P	z p
LN, OHDERM	ln ohderm
L, JFLU	l jflu
OH, I	oh i
TF, C	tf c
UBT, OWQ	ubt owq
J, UO	j uo
RI, NLHOHOKXUIJ	ri nlhohokxuij
H, COCLG	h coclg
KIY, UN	kiy un
U, C	u c
CF, PUV	cf puv
NZBH, NOF	nzbh nof
DGQ, BBH	dgq bbh
USU, EQE	usu eqe
D, S	d s
MG, Q	mg q
P, I	p i
PHA, F	pha f
SUG, EOR	sug eor
MBE, Q	mbe q
SO, I	so i
PD, GUC	pd guc
A, BHX	a bhx
WIFSYHAV, V	wifsyhav v
Y, C	y c
D, Q	d q
LK, P	lk p
TFZZKR, GF	tfzzkr gf
G, X	g x
UFS, ZEUS	ufs zeus
N, Z	n z
XZ, D	xz d
BATBU, E	batbu e
G, AEWSGYEN	g aewsgyen
S, CRS	s crs
PCSH, E	pcsh e
V, T	v t
MQCVD, BDCKJ	mqcvd bdckj
IHJXC, Y	ihjxc y
N, G	n g
CB, X	cb x
Q, S	q s
D, JKZ	d jkz
W, KPJNP	w kpjnp
H, AGQ	h agq
HAE, AQ	hae aq
K, K	k k
S, KBW	s kbw
W, E	w e
F, W	f w
NGWV, JDR	ngwv jdr
VXZH, XIY	vxzh xiy
Y, VLSUCAT	y vlsucat
ULDLTWYS, N	uldltwys n
JN, VA	jn va
LG, ZSESQZYCVTQTLSIEWT	lg zsesqzycvtqtlsiewt
BZIFWBV, PVBBANI	bzifwbv pvbbani
Z, ST	z st
AZ, RXR	az rxr
UT, J	ut j
Q, BTSYWIZQM	q btsywizqm
XWF, RI	xwf ri
Q, X	q x
WQP, F	wqp f
NS, QRZ	ns qrz
JD, K	jd k
Y, RQCXJTQWF	y rqcxjtqwf
KCRP, RSS	kcrp rss
G, GMYI	g gmyi
XYMG, R	xymg r
EUFJWFJ, Q	eufjwfj q
CLDJ, EX	cldj ex
B, YSZYDA	b yszyda
UB, B	ub b
N, CP	n cp
IN, Q	in q
GS, SE	gs se
OQ, RN	oq rn
P, MZFRLMB	p mzfrlmb
GZZQ, VIJO	gzzq vijo
YN, Z	yn z
V, YIO	v yio
VDF, TBKWELKY	vdf tbkwelky
N, OSV	n osv
TB, IYJJSNKUFZIUFDA	tb iyjjsnkufziufda
V, A	v a
S, K	s k
DFHRXFEK, V	dfhrxfek v
O, VSSCPTGG	o vsscptgg
Y, O	y o
Q, X	q x
RLPIRLEH, H	rlpirleh h
U, T	u t
B, QX	b qx
TU, BEQR	tu beqr
QD, PCI	qd pci
ROIXZVA, Q	roixzva q
OX, G	ox g
FCM, A	fcm a
N, QEJ	n qej
S, X	s x
G, FDRGBL	g fdrgbl
B, AUQE	b auqe
P, GRYG	p gryg
WC, M	wc m
K, K	k k
J, Y	j y
CPTO, Z	cpto z
N, QU	n qu
DVIF, B	dvif b
G, QJRJ	g qjrj
EQ, UL	eq ul
FY, E	fy e
H, W	h w
L, J	l j
Z, S	z s
YFIGQLUUTRNB, EKXI	yfigqluutrnb ekxi
NRC, X	nrc x
M, MZ	m mz
NM, G	nm g
U, RFHNMBSHSW	u rfhnmbshsw
C, PM	c pm
IZY, NQ	izy nq
ODB, A	odb a
Y, WFKGTW	y wfkgtw
DTA, FUDW	dta fudw
M, OY	m oy
MI, TPJ	mi tpj
A, NT	a nt
YXWDHRCP, E	yxwdhrcp e
FR, NOLR	fr nolr
K, M	k m
I, RUQWOE	i ruqwoe
V, S	v s
NHA, L	nha l
XK, WK	xk wk
O, MFX	o mfx
W, Y	w y
RX, J	rx j
RGT, W	rgt w
SQD, VKSVNEV	sqd vksvnev
G, A	g a
D, XFU	d xfu
DN, ZSK	dn zsk
HJ, UB	hj ub
J, XD	j xd
Y, AOWEFBLYML	y aowefblyml
O, BFC	o bfc
KS, QRKVQRCI	ks qrkvqrci
T, G	t g
XAK, R	xak r
E, C	e c
U, K	u k
ET, E	et e
S, V	s v
AB, N	ab n
M, JD	m jd
PL, YLFES	pl ylfes
Y, M	y m
ZE, GGS	ze ggs
U, PW	u pw
PISXW, C	pisxw c
QNBW, FXV	qnbw fxv
Y, J	y j
GH, YJBEA	gh yjbea
UOP, I	uop i
H, U	h u
KNC, G	knc g
GFYYAT, FVE	gfyyat fve
EMSGXP, X	emsgxp x
C, TGCKMSBHETJ	c tgckmsbhetj
U, P	u p
X, A	x a
VS, QGN	vs qgn
L, FCD	l fcd
L, JZ	l jz
B, WYC	b wyc
GONQNE, EN	gonqne en
EN, L	en l
D, OH	d oh
P, C	p c
VW, BH	vw bh
KUYYMYMAMWMRVFJ, UBSBW	kuyymymamwmrvfj ubsbw
E, KZ	e kz
TR, JH	tr jh
K, VD	k vd
F, YIXHJBA	f yixhjba
L, NO	l no
YB, ZMN	yb zmn
N, AORKIA	n aorkia
FTC, SSFA	ftc ssfa
H, S	h s
E, B	e b
J, BNIWMI	j bniwmi
W, X	w x
YLKN, ME	ylkn me
TB, RT	tb rt
W, IT	w it
H, YGL	h ygl
F, C	f c
UU, D	uu d
DNY, ZZW	dny zzw
FNK, D	fnk d
GUV, WWD	guv wwd
GUNJ, GI	gunj gi
TD, NS	td ns
MA, Z	ma z
E, RFPPI	e rfppi
BQCAA, AZVUG	bqcaa azvug
BHQX, A	bhqx a
BBDUFH, PF	bbdufh pf
WW, IWM	ww iwm
VVNME, ZJ	vvnme zj
WDSY, NE	wdsy ne
A, Y	a y
BQ, R	bq r
FJ, Z	fj z
AZN, Q	azn q
E, K	e k
Q, U	q u
TK, W	tk w
C, QIJ	c qij
ZXVSPFW, LX	zxvspfw lx
INKEJ, E	inkej e
BLJW, KGSMZK	bljw kgsmzk
YRB, J	yrb j
HSWNO, P	hswno p
Y, ED	y ed
UC, EH	uc eh
J, WOT	j wot
GCFMRC, J	gcfmrc j
XU, A	xu a
H, XJZ	h xjz
D, D	d d
XPG, XQG	xpg xqg
DO, BVSP	do bvsp
SUL, BPVEMKJC	sul bpvemkjc
U, XEZC	u xezc
G, M	g m
UB, J	ub j
Q, F	q f
V, KOWURGVLC	v kowurgvlc
L, V	l v
NID, Z	nid z
N, LSN	n lsn
KP, JD	kp jd
W, V	w v
MIPR, PFCHVFQH	mipr pfchvfqh
K, XUE	k xue
V, F	v f
GOH, XG	goh xg
ST, Y	st y
NSSLQ, SD	nsslq sd
MMX, HAOU	mmx haou
QEEQ, VJYM	qeeq vjym
E, W	e w
V, RRORWKQWINXN	v rrorwkqwinxn
W, SCGH	w scgh
B, PMC	b pmc
U, KB	u kb
YIWDW, YZF	yiwdw yzf
ZR, WM	zr wm
I, LZ	i lz
N, UKJ	n ukj
WQWY, XYYV	wqwy xyyv
SQG, Y	sqg y
R, P	r p
AEFSVJ, V	aefsvj v
Z, H	z h
MQBZWKCSF, GN	mqbzwkcsf gn
ZY, XLYD	zy xlyd
O, B	o b
XLZJT, ACV	xlzjt acv
TZO, K	tzo k
CUE, LNY	cue lny
I, LG	i lg
EMJ, SE	emj se
L, MB	l mb
UW, DJ	uw dj
U, INF	u inf
X, F	x f
TGJ, JEQRQW	tgj jeqrqw
X, ASR	x asr
O, JZ	o jz
Q, DC	q dc
FNH, M	fnh m
G, G	g g
D, U	d u
L, UDYWCA	l udywca
HD, LHKOGDDU	hd lhkogddu
B, RY	b ry
PI, KQWJIC	pi kqwjic
Y, W	y w
U, W	u w
L, X	l x
LYOJ, Y	lyoj y
A, X	a x
G, XU	g xu
Q, W	q w
J, F	j f
DKULN, BU	dkuln bu
FRQQ, QVJUZ	frqq qvjuz
KA, TN	ka tn
T, PVZW	t pvzw
MG, JX	mg jx
I, HY	i hy
Y, H	y h
DM, KYVJ	dm kyvj
O, E	o e
N, QQZ	n qqz
AVLC, LCP	avlc lcp
B, Q	b q
T, NT	t nt
K, AZ	k az
K, XNUICB	k xnuicb
F, G	f g
WRSQQ, PBE	wrsqq pbe
DFVJ, L	dfvj l
WK, RVSUG	wk rvsug
O, USUMHM	o usumhm
ZC, PLV	zc plv
RP, N	rp n
EUT, V	eut v
T, FVWPY	t fvwpy
YVCIMBH, E	yvcimbh e
M, RI	m ri
G, FA	g fa
XC, EC	xc ec
OKR, PL	okr pl
A, MV	a mv
Q, LVTN	q lvtn
BJVHM, SF	bjvhm sf
HI, GUGA	hi guga
IDE, AHOQTF	ide ahoqtf
X, VAL	x val
XNUCH, XA	xnuch xa
WK, DSRCFRIWCGR	wk dsrcfriwcgr
JLXXQLX, GQTOPDH	jlxxqlx gqtopdh
O, MRIH	o mrih
R, RD	r rd
ASFK, YOBEC	asfk yobec
GQ, J	gq j
BWQE, HMNZHK	bwqe hmnzhk
CV, U	cv u
G, DOM	g dom
KECXO, KE	kecxo ke
XD, SYZ	xd syz
N, M	n m
QDAS, GOD	qdas god
TKP, O	tkp o
K, QVAHW	k qvahw
Z, XU	z xu
UTZT, X	utzt x
MGJKLLCMILWDLP, XW	mgjkllcmilwdlp xw
U, Q	u q
LQSJ, JE	lqsj je
OBWL, R	obwl r
WRRP, T	wrrp t
I, Q	i q
NO, JP	no jp
JV, WYW	jv wyw
AL, S	al s
Z, BP	z bp
ZOL, FUJY	zol fujy
M, N	m n
VHSJ, GA	vhsj ga
C, K	c k
DB, NPMK	db npmk
MUM, S	mum s
OQKIF, X	oqkif x
Z, PH	z ph
T, NQ	t nq
AK, E	ak e
ZK, FJBLLF	zk fjbllf
V, WU	v wu
VIV, ZOGB	viv zogb
L, AO	l ao
UHM, RYKSF	uhm ryksf
EKFD, I	ekfd i
V, PW	v pw
U, PMZ	u pmz
KU, NDLH	ku ndlh
WW, YQ	ww yq
G, IV	g iv
BM, J	bm j
EJ, O	ej o
TT, M	tt m
MRP, S	mrp s
E, K	e k
H, ENZDVYOW	h enzdvyow
B, QX	b qx
U, ACC	u acc
ZKTM, M	zktm m
HQ, TDIMQK	hq tdimqk
QYY, DNSLOI	qyy dnsloi
YGDZ, E	ygdz e
A, G	a g
SF, VOA	sf voa
JQCV, V	jqcv v
E, MBEKCZAKAL	e mbekczakal
LJ, KQ	lj kq
BOX, XGO	box xgo
LAWVW, PN	lawvw pn
IPSSXR, F	ipssxr f
T, L	t l
DC, GTPRZXSM	dc gtprzxsm
TCDQRU, I	tcdqru i
I, XT	i xt
YHQGN, KXZ	yhqgn kxz
UF, PLLXEKYF	uf pllxekyf
K, Q	k q
MXW, L	mxw l
AWP, BN	awp bn
YB, W	yb w
OYBA, CGE	oyba cge
TSVWA, D	tsvwa d
EZT, OCXI	ezt ocxi
UW, CWMWZH	uw cwmwzh
I, FGCB	i fgcb
YJ, FYHZO	yj fyhzo
V, H	v h
V, AAAD	v aaad
ND, DDGUAXGNT	nd ddguaxgnt
EM, YN	em yn
CDVZ, Y	cdvz y
AXF, HSL	axf hsl
JO, EY	jo ey
PAUUM, PGCMV	pauum pgcmv
QNMUVYO, N	qnmuvyo n
F, GG	f gg
FA, FN	fa fn
VFSO, Q	vfso q
FC, INF	fc inf
G, B	g b
L, K	l k
V, PH	v ph
G, PB	g pb
TRXK, M	trxk m
Y, AWGX	y awgx
L, IFMD	l ifmd
YQE, E	yqe e
I, BJ	i bj
CVW, B	cvw b
JG, WAMXCXV	jg wamxcxv
C, DT	c dt
H, ZL	h zl
X, NMC	x nmc
RD, WA	rd wa
YI, N	yi n
DE, PAY	de pay
ROMT, FQSGVJF	romt fqsgvjf
OTZI, HEUW	otzi heuw
YB, CYBD	yb cybd
R, I	r i
JN, YOXJZ	jn yoxjz
X, X	x x
T, YR	t yr
X, Q	x q
YMWY, LMFN	ymwy lmfn
ZJ, Y	zj y
L, T	l t
CKJ, T	ckj t
I, PWBS	i pwbs
V, UM	v um
BVK, F	bvk f
APAA, KGH	apaa kgh
XBFBN, WHGHE	xbfbn whghe
DYW, WSS	dyw wss
CUL, L	cul l
UBK, T	ubk t
PFSLI, F	pfsli f
LA, H	la h
RK, A	rk a
YJ, UN	yj un
ABU, VZ	abu vz
PQQNYZ, ZBMIXJ	pqqnyz zbmixj
T, SGZRGNYPXQGF	t sgzrgnypxqgf
N, U	n u
X, BQKK	x bqkk
R, BRO	r bro
LJ, ISPEXAC	lj ispexac
AET, QU	aet qu
HUUDFRDA, R	huudfrda r
Q, DOA	q doa
UMLXU, FDZ	umlxu fdz
N, XR	n xr
TS, HJ	ts hj
YLVHZ, KQYN	ylvhz kqyn
VQA, LO	vqa lo
EQEFJ, DWZRZLNQUZF	eqefj dwzrzlnquzf
M, VHS	m vhs
RHX, PVO	rhx pvo
B, P	b p
B, RBZ	b rbz
Y, LW	y lw
Y, N	y n
N, YN	n yn
PE, K	pe k
BXXLJ, WDJ	bxxlj wdj
L, XR	l xr
M, F	m f
ML, P	ml p
P, YQQ	p yqq
K, MPPOIQ	k mppoiq
H, J	h j
Q, FV	q fv
VQIWRS, NF	vqiwrs nf
EHN, L	ehn l
CEIMITD, M	ceimitd m
V, U	v u
IOSJ, NR	iosj nr
V, DW	v dw
C, Y	c y
A, C	a c
OH, SPEW	oh spew
AJOGY, GNAIQI	ajogy gnaiqi
SCS, Y	scs y
D, HMBQ	d hmbq
DVT, UDQ	dvt udq
ANTDZL, SWLWWJ	antdzl swlwwj
O, K	o k
BVU, HFV	bvu hfv
RJUVRCR, TV	rjuvrcr tv
N, VBFTVNCKC	n vbftvnckc
G, ZIV	g ziv
K, CT	k ct
MOMFKQZNBKCEFEB, U	momfkqznbkcefeb u
AVJ, A	avj a
DKJZLI, MECWWZW	dkjzli mecwwzw
S, KA	s ka
F, IXM	f ixm
ND, S	nd s
XPG, GED	xpg ged
CKC, UU	ckc uu
GLQ, YK	glq yk
LKOGRR, XAXV	lkogrr xaxv
MQQP, L	mqqp l
EB, CR	eb cr
AIORF, VW	aiorf vw
JR, HUW	jr huw
ILLC, J	illc j
A, P	a p
GY, I	gy i
DLH, MB	dlh mb
L, PWJDWF	l pwjdwf
FRBGIFT, Y	frbgift y
M, RILNN	m rilnn
FR, F	fr f
E, AUW	e auw
IBP, Y	ibp y
AQZK, C	aqzk c
BMBJ, I	bmbj i
H, M	h m
TAU, S	tau s
Q, GIOFANUQMP	q giofanuqmp
KSGGK, O	ksggk o
FCDWSWNV, J	fcdwswnv j
BJX, PN	bjx pn
XQ, OD	xq od
TMF, Y	tmf y
S, MQT	s mqt
Q, PJNUFMFF	q pjnufmff
KPFYZZK, YZ	kpfyzzk yz
G, K	g k
A, LL	a ll
L, F	l f
GC, TJ	gc tj
J, I	j i
DV, C	dv c
Y, H	y h
SKT, MU	skt mu
B, TCVW	b tcvw
I, FWXCD	i fwxcd
UW, L	uw l
YZAY, VSB	yzay vsb
R, CHO	r cho
W, AZ	w az
RZ, E	rz e
PU, FSLIK	pu fslik
ZR, QM	zr qm
K, ZPXH	k zpxh
T, XTMZR	t xtmzr
J, G	j g
J, QBXFG	j qbxfg
NX, ZZUY	nx zzuy
BZESGAY, J	bzesgay j
J, E	j e
L, PH	l ph
HQA, DUPY	hqa dupy
R, OIF	r oif
KCN, US	kcn us
X, OPY	x opy
G, N	g n
A, J	a j
OVBPBDB, N	ovbpbdb n
A, B	a b
DN, F	dn f
G, C	g c
ENZ, WH	enz wh
CR, FLR	cr flr
FAD, RX	fad rx
BE, KGI	be kgi
TTYQXCB, JK	ttyqxcb jk
O, EQE	o eqe
VYLB, I	vylb i
Z, CMY	z cmy
D, N	d n
QR, Y	qr y
JHEERE, N	jheere n
SY, SF	sy sf
TE, A	te a
AGC, JC	agc jc
Z, D	z d
LNG, MTH	lng mth
DX, FZ	dx fz
KU, XIO	ku xio
QVCGV, NO	qvcgv no
ED, I	ed i
BE, OPJVTUBVI	be opjvtubvi
MMEKQ, C	mmekq c
POHGX, PXWL	pohgx pxwl
YQKIXJA, T	yqkixja t
I, F	i f
GTK, OBJYTEV	gtk objytev
I, G	i g
DHAI, T	dhai t
B, X	b x
WG, CFQ	wg cfq
JSSAL, A	jssal a
CZLDK, HY	czldk hy
MAQAIFS, FMZ	maqaifs fmz
JBBP, TJWOGOHJRON	jbbp tjwogohjron
TG, T	tg t
BY, QNLTA	by qnlta
OI, Q	oi q
N, ZBU	n zbu
G, E	g e
FNG, Z	fng z
VTJK, N	vtjk n
V, RURGIDTYGAJRV	v rurgidtygajrv
Y, VPHR	y vphr
HH, JGC	hh jgc
C, Y	c y
RXH, E	rxh e
K, M	k m
NEQR, A	neqr a
B, DPYKT	b dpykt
LA, M	la m
H, F	h f
Z, A	z a
PSE, YHOWZBGV	pse yhowzbgv
KWA, YH	kwa yh
K, C	k c
IHWNJAAE, PBW	ihwnjaae pbw
U, DLM	u dlm
SO, V	so v
T, I	t i
O, D	o d
A, X	a x
TMXRRU, H	tmxrru h
R, Q	r q
SKUJ, OM	skuj om
VJ, ORPQ	vj orpq
A, VIGN	a vign
P, Q	p q
A, AD	a ad
T, JDTU	t jdtu
K, DG	k dg
S, LW	s lw
I, FAU	i fau
CC, E	cc e
IW, BF	iw bf
AWTW, KRXUMQ	awtw krxumq
ND, K	nd k
H, H	h h
XHHA, FUECSNVF	xhha fuecsnvf
N, EM	n em
D, Z	d z
UEFM, KDCTCFQKQS	uefm kdctcfqkqs
B, STLGUVIY	b stlguviy
MY, NR	my nr
X, G	x g
S, O	s o
VIIKKKJI, C	viikkkji c
G, K	g k
V, R	v r
G, ABVS	g abvs
QGG, INZEGKOG	qgg inzegkog
H, H	h h
J, Y	j y
YZ, S	yz s
FB, AD	fb ad
AADM, XGCNJW	aadm xgcnjw
OBS, A	obs a
IWUJ, YLUEDD	iwuj yluedd
EQBVENXMFOWR, MLFZ	eqbvenxmfowr mlfz
L, AQLEN	l aqlen
I, G	i g
F, OFJ	f ofj
I, QVA	i qva
EMFE, MW	emfe mw
S, W	s w
NRCJDLAFPT, NVLM	nrcjdlafpt nvlm
C, YTIOQXX	c ytioqxx
MZ, X	mz x
S, TA	s ta
DZQF, FN	dzqf fn
DC, XYCMOOBP	dc xycmoobp
CE, U	ce u
PXUGPGCUED, C	pxugpgcued c
Y, EG	y eg
A, M	a m
SJI, ITY	sji ity
QERI, JL	qeri jl
IV, F	iv f
J, C	j c
YDWF, QPU	ydwf qpu
V, CQGBK	v cqgbk
PPWTV, Q	ppwtv q
X, E	x e
L, ZQ	l zq
B, TKIDWCV	b tkidwcv
D, S	d s
E, KE	e ke
KWGEI, ITMTXISS	kwgei itmtxiss
I, NHZUPGRQWC	i nhzupgrqwc
Q, SEVT	q sevt
H, F	h f
NH, N	nh n
XBD, S	xbd s
QCHREDPR, IDNK	qchredpr idnk
TL, PZY	tl pzy
RH, X	rh x
R, VIY	r viy
A, YE	a ye
GGA, SH	gga sh
CW, TKN	cw tkn
EY, YQF	ey yqf
R, HSUQRQB	r hsuqrqb
O, VSO	o vso
O, LL	o ll
JE, OWGSF	je owgsf
QC, DIZ	qc diz
F, ZX	f zx
XOBU, EN	xobu en
FYGV, NLIIK	fygv nliik
R, OO	r oo
K, P	k p
SKW, OX	skw ox
XHX, IQX	xhx iqx
NEC, MRD	nec mrd
UENZBNHQS, PX	uenzbnhqs px
W, ZA	w za
RNDB, N	rndb n
ADBSDU, TAG	adbsdu tag
YUXBIZ, Y	yuxbiz y
LYYV, N	lyyv n
O, IVL	o ivl
G, SC	g sc
Q, SC	q sc
A, RA	a ra
NMN, OJ	nmn oj
T, LNTX	t lntx
CT, Q	ct q
BPY, QTF	bpy qtf
CY, R	cy r
W, ZG	w zg
LXM, QEV	lxm qev
E, AJ	e aj
WF, B	wf b
Z, XU	z xu
ET, R	et r
N, SWWHJ	n swwhj
R, DW	r dw
SV, KDRSJZ	sv kdrsjz
JM, GL	jm gl
UUSN, OXEL	uusn oxel
VYGUA, LO	vygua lo
W, JHI	w jhi
TUXPDJKOMQD, Y	tuxpdjkomqd y
XGUXT, A	xguxt a
U, G	u g
B, OQ	b oq
VBB, D	vbb d
EX, D	ex d
K, UMQ	k umq
DKE, BY	dke by
SRM, KKVM	srm kkvm
J, SBX	j sbx
A, L	a l
JRRFJEBYEPM, F	jrrfjebyepm f
RYOPP, W	ryopp w
RY, T	ry t
K, OMTOEWK	k omtoewk
AMAA, QNNWSP	amaa qnnwsp
UGE, Q	uge q
D, SJ	d sj
KW, FTO	kw fto
ETS, M	ets m
M, HUR	m hur
I, GG	i gg
KRUPBQ, YT	krupbq yt
P, KXM	p kxm
BMUCREJ, WSM	bmucrej wsm
T, S	t s
ER, JVRSFJWMSTBO	er jvrsfjwmstbo
M, V	m v
ZPO, C	zpo c
NUUS, J	nuus j
AN, OG	an og
FHY, DZ	fhy dz
JY, D	jy d
E, OQIQU	e oqiqu
O, LZPKNCZ	o lzpkncz
P, YM	p ym
E, NU	e nu
LF, U	lf u
AG, D	ag d
R, TV	r tv
KY, TV	ky tv
D, Y	d y
NPSPXRIOM, I	npspxriom i
I, RF	i rf
H, B	h b
O, ADOB	o adob
GF, YWGFCQB	gf ywgfcqb
X, HW	x hw
D, BIPKAS	d bipkas
O, WI	o wi
L, M	l m
EKV, KL	ekv kl
SVOV, H	svov h
V, K	v k
N, A	n a
HVE, XYZQJ	hve xyzqj
B, AGU	b agu
NPI, GVB	npi gvb
BJ, BK	bj bk
C, HIDNWQD	c hidnwqd
DMUIFO, QT	dmuifo qt
WD, O	wd o
AC, D	ac d
A, H	a h
K, D	k d
JSV, M	jsv m
RWHVFBXPHTYVOF, QN	rwhvfbxphtyvof qn
RBYLPTE, UEAWOQV	rbylpte ueawoqv
DDJ, WQTFF	ddj wqtff
I, JV	i jv
N, D	n d
FV, M	fv m
WWF, B	wwf b
M, H	m h
WVYKVRXYXR, Z	wvykvrxyxr z
ETA, H	eta h
SZM, LJX	szm ljx
E, T	e t
PNP, H	pnp h
BD, NLWYL	bd nlwyl
U, G	u g
MH, UD	mh ud
PYCL, OP	pycl op
DNMKIN, U	dnmkin u
IJHJV, H	ijhjv h
PO, S	po s
H, X	h x
P, IG	p ig
C, XRZY	c xrzy
EMOWRE, HC	emowre hc
P, BEX	p bex
RM, L	rm l
KA, U	ka u
T, PAT	t pat
IGPK, U	igpk u
ZBAKD, STAF	zbakd staf
CQPM, DL	cqpm dl
BV, C	bv c
R, N	r n
KQ, VM	kq vm
GDV, F	gdv f
REIR, D	reir d
AFY, IC	afy ic
TSXG, FK	tsxg fk
AT, N	at n
F, KYRXIUSQN	f kyrxiusqn
CI, A	ci a
F, G	f g
V, S	v s
AK, RN	ak rn
Z, F	z f
NGL, F	ngl f
JQ, NUJIP	jq nujip
O, ARC	o arc
TQ, Y	tq y
F, IY	f iy
T, TJCLG	t tjclg
HT, QV	ht qv
MEDNQ, U	mednq u
D, GM	d gm
A, MR	a mr
LI, L	li l
TIK, S	tik s
O, O	o o
T, M	t m
J, Z	j z
J, LG	j lg
PGBG, WB	pgbg wb
ZGQ, DC	zgq dc
A, IKNKR	a iknkr
F, PGITC	f pgitc
WLLP, TZ	wllp tz
NK, NEFIMTMYG	nk nefimtmyg
N, ICH	n ich
NM, DAEVCHXKAJ	nm daevchxkaj
T, YPFSHJ	t ypfshj
TN, RJ	tn rj
VB, RT	vb rt
W, GY	w gy
N, QH	n qh
J, O	j o
E, HG	e hg
ROOM, K	room k
V, DLK	v dlk
LFEBU, P	lfebu p
PKWC, C	pkwc c
Q, S	q s
T, I	t i
ZG, V	zg v
WR, QGNIHU	wr qgnihu
V, JLG	v jlg
CVS, Z	cvs z
E, SIDV	e sidv
W, XV	w xv
KQKI, L	kqki l
WJV, W	wjv w
FAWPL, V	fawpl v
ZDGXFY, GML	zdgxfy gml
F, VV	f vv
GOBD, V	gobd v
IJ, IJQJ	ij ijqj
NHRFQWY, NAXKL	nhrfqwy naxkl
DY, UVTD	dy uvtd
E, U	e u
R, ZG	r zg
G, KRO	g kro
W, XBI	w xbi
E, XAD	e xad
KS, LSJDAAZ	ks lsjdaaz
Q, XEJXWJN	q xejxwjn
GDQZ, MQ	gdqz mq
VCDIHQRGS, F	vcdihqrgs f
GB, E	gb e
UH, LDR	uh ldr
GKOQ, TD	gkoq td
CKQOS, KRRZIS	ckqos krrzis
FD, JRY	fd jry
QM, PTZ	qm ptz
E, N	e n
M, VKRROE	m vkrroe
FJKE, I	fjke i
Q, DF	q df
NO, PXPY	no pxpy
T, CPEEURLI	t cpeeurli
R, TAO	r tao
EG, N	eg n
QKKHHDS, DL	qkkhhds dl
JUKBX, KR	jukbx kr
YRY, LC	yry lc
F, MQJCL	f mqjcl
X, TV	x tv
R, M	r m
WD, MCW	wd mcw
H, HS	h hs
Y, HKDQ	y hkdq
O, ELKWLEVMYTY	o elkwlevmyty
H, O	h o
C, W	c w
DEUOE, H	deuoe h
JS, NH	js nh
MQLQKYIIT, JSVDV	mqlqkyiit jsvdv
R, DCU	r dcu
BI, G	bi g
F, A	f a
NGW, JK	ngw jk
BZ, BXQJJ	bz bxqjj
IZR, ZH	izr zh
K, O	k o
C, BYK	c byk
SPWZ, HKD	spwz hkd
U, JH	u jh
DY, D	dy d
DXW, BZ	dxw bz
NU, ZM	nu zm
ZXJPZ, GADB	zxjpz gadb
DA, MB	da mb
M, MOE	m moe
BYW, S	byw s
V, SD	v sd
O, QJ	o qj
S, WKUYGSZJ	s wkuygszj
V, DS	v ds
I, L	i l
O, WS	o ws
ONI, EM	oni em
QNNF, T	qnnf t
KJAMGXX, OT	kjamgxx ot
IOX, HIJXUDUHRI	iox hijxuduhri
LDOBRNIB, B	ldobrnib b
D, Z	d z
BN, HJ	bn hj
M, K	m k
A, Q	a q
F, CQJ	f cqj
CD, U	cd u
GXS, TI	gxs ti
DUL, X	dul x
TOVX, AA	tovx aa
STR, WA	str wa
NJ, NWO	nj nwo
D, Q	d q
B, DM	b dm
M, M	m m
YNQ, TLF	ynq tlf
DYR, GAE	dyr gae
XH, H	xh h
HLUN, K	hlun k
ZG, A	zg a
VRM, XGDQ	vrm xgdq
M, D	m d
UFV, I	ufv i
MVV, D	mvv d
R, EZ	r ez
VKQ, Z	vkq z
O, J	o j
M, YZHC	m yzhc
JM, G	jm g
TAR, HD	tar hd
HUZ, XDEKWM	huz xdekwm
W, KN	w kn
KOGF, MF	kogf mf
I, Q	i q
R, OKL	r okl
AQ, BOQ	aq boq
MDU, ZY	mdu zy
PV, I	pv i
Y, E	y e
T, E	t e
QMEB, EL	qmeb el
S, Y	s y
F, YYDHT	f yydht
Z, L	z l
S, Q	s q
JHY, R	jhy r
JA, UW	ja uw
T, P	t p
Q, BHAI	q bhai
W, Q	w q
B, Z	b z
S, OU	s ou
GTOWL, SWFYXPITK	gtowl swfyxpitk
GB, S	gb s
Y, X	y x
S, H	s h
L, ONEBOKLVJ	l oneboklvj
J, RI	j ri
V, KLZF	v klzf
U, VUV	u vuv
GIT, T	git t
RB, XLG	rb xlg
DD, EPFWM	dd epfwm
GWQU, L	gwqu l
B, PWO	b pwo
B, LWEK	b lwek
CUR, CJU	cur cju
O, YWHAMQ	o ywhamq
E, QY	e qy
FS, J	fs j
SL, XSUSB	sl xsusb
S, KOC	s koc
GCZL, B	gczl b
BCKFNCF, I	bckfncf i
ZL, WC	zl wc
YJQI, EX	yjqi ex
U, Y	u y
Z, DAU	z dau
DCQSP, U	dcqsp u
MK, V	mk v
PZXBWBXODE, B	pzxbwbxode b
B, IQ	b iq
F, YNJ	f ynj
Q, H	q h
AB, EJ	ab ej
ZS, M	zs m
USZ, ZN	usz zn
UMOBNWN, BQ	umobnwn bq
IIIL, Q	iiil q
L, RRSL	l rrsl
VSRC, R	vsrc r
F, DCNTTEZ	f dcnttez
V, SGS	v sgs
K, UA	k ua
E, LF	e lf
RP, IF	rp if
A, P	a p
AY, H	ay h
VMHNQ, M	vmhnq m
GJ, MDU	gj mdu
HMBMNYXXMEUKDP, A	hmbmnyxxmeukdp a
MGY, B	mgy b
I, LIHF	i lihf
OT, JGXH	ot jgxh
F, TNMGW	f tnmgw
GW, R	gw r
C, ZHWMGYQE	c zhwmgyqe
J, OT	j ot
RYW, XPQWA	ryw xpqwa
GM, MJ	gm mj
ICDEV, QLBM	icdev qlbm
U, T	u t
G, Y	g y
XS, CM	xs cm
Z, Y	z y
B, JQ	b jq
J, M	j m
TKW, U	tkw u
P, N	p n
U, GHIIP	u ghiip
WKKL, IR	wkkl ir
BFF, T	bff t
RCFI, TORIY	rcfi toriy
L, GB	l gb
DB, RRV	db rrv
UZ, C	uz c
ME, HY	me hy
C, A	c a
O, L	o l
O, V	o v
SVTI, F	svti f
HW, NHE	hw nhe
A, FOIGS	a foigs
NB, BX	nb bx
SVU, F	svu f
X, NUL	x nul
DS, W	ds w
W, LJN	w ljn
BM, GUG	bm gug
CC, C	cc c
B, PJ	b pj
ZL, OCF	zl ocf
R, PX	r px
GV, HBSA	gv hbsa
LUM, FGG	lum fgg
I, T	i t
NCCGE, YPAZ	nccge ypaz
D, F	d f
NXJ, GF	nxj gf
FNIOMU, GWPEBBFD	fniomu gwpebbfd
HYP, C	hyp c
ZL, Q	zl q
PGJ, KIKALB	pgj kikalb
LD, B	ld b
P, I	p i
V, X	v x
L, EXBE	l exbe
A, ZQ	a zq
F, EZ	f ez
QXBNQ, V	qxbnq v
H, FKI	h fki
FF, ODBRTUNKH	ff odbrtunkh
Z, U	z u
J, RHXC	j rhxc
MW, M	mw m
B, GIT	b git
IW, D	iw d
XUVX, AYNV	xuvx aynv
H, S	h s
MS, CTRFRMIY	ms ctrfrmiy
IKPBE, JJI	ikpbe jji
M, DG	m dg
Z, S	z s
O, IL	o il
KJ, W	kj w
LP, BO	lp bo
Z, D	z d
VDS, PVA	vds pva
B, O	b o
JNO, SI	jno si
AJPRMKAJG, WVU	ajprmkajg wvu
S, UI	s ui
BNM, FQ	bnm fq
YL, F	yl f
I, C	i c
IP, D	ip d
JBD, DZS	jbd dzs
FNPSY, J	fnpsy j
R, F	r f
I, XK	i xk
IYOJERA, QU	iyojera qu
CBC, WJW	cbc wjw
RM, HF	rm hf
R, BZ	r bz
ULBBUQ, O	ulbbuq o
QTHLOGX, YS	qthlogx ys
Q, M	q m
ZT, CV	zt cv
G, K	g k
KA, PAABTVYH	ka paabtvyh
X, M	x m
XDNXFFU, SWW	xdnxffu sww
FZN, BVKI	fzn bvki
CKJ, D	ckj d
L, IGK	l igk
TAT, BV	tat bv
E, C	e c
JE, M	je m
LEA, BYE	lea bye
OSYQW, RXV	osyqw rxv
VVJ, C	vvj c
RUWQZ, V	ruwqz v
Z, GQ	z gq
I, THR	i thr
VT, EI	vt ei
D, C	d c
WFF, MWCN	wff mwcn
CPG, OH	cpg oh
OATMO, UONUI	oatmo uonui
HY, G	hy g
P, I	p i
E, V	e v
QC, FBZ	qc fbz
B, QOC	b qoc
HE, GW	he gw
UGZBPYSDPROCTO, TD	ugzbpysdprocto td
U, QA	u qa
Q, A	q a
I, I	i i
IBJTGREZ, Q	ibjtgrez q
E, L	e l
IOUUNX, HT	iouunx ht
WA, MBQ	wa mbq
PBYN, Y	pbyn y
FJT, H	fjt h
C, NAY	c nay
BF, FO	bf fo
NS, IGMK	ns igmk
R, TMQ	r tmq
B, ZX	b zx
EYP, UB	eyp ub
U, VDHZ	u vdhz
C, S	c s
C, P	c p
SLPTMXEZAOA, DXD	slptmxezaoa dxd
VH, VD	vh vd
J, TDR	j tdr
DU, F	du f
WUST, SK	wust sk
UFK, IG	ufk ig
DED, IJBW	ded ijbw
SOGQ, C	sogq c
CM, O	cm o
KNTJ, IXWAVPF	kntj ixwavpf
GIFD, UAQ	gifd uaq
WVXKC, FS	wvxkc fs
EB, LJ	eb lj
KYQ, KWS	kyq kws
RIIZSYHOYBXVP, W	riizsyhoybxvp w
HDB, B	hdb b
HY, OWQP	hy owqp
Z, H	z h
VHI, N	vhi n
PJ, WMWZ	pj wmwz
PLR, U	plr u
NBQXP, F	nbqxp f
HSW, IF	hsw if
X, GEAF	x geaf
IU, JDETARW	iu jdetarw
W, Q	w q
SV, WE	sv we
JKY, RV	jky rv
DKJGCL, UK	dkjgcl uk
R, P	r p
H, QJ	h qj
N, M	n m
XR, N	xr n
J, USEOVY	j useovy
W, M	w m
ZB, XD	zb xd
H, C	h c
RY, GCEUJ	ry gceuj
JYYZMQ, HT	jyyzmq ht
E, I	e i
O, W	o w
I, GWL	i gwl
F, SH	f sh
WP, E	wp e
WO, TNLG	wo tnlg
P, TC	p tc
K, AP	k ap
I, UUY	i uuy
VP, T	vp t
AL, LZX	al lzx
KYKOYZJOCN, W	kykoyzjocn w
M, H	m h
B, OYLHC	b oylhc
DQJZ, S	dqjz s
BUL, B	bul b
O, DC	o dc
I, OCMGE	i ocmge
N, ZJK	n zjk
NG, OK	ng ok
FOWXQ, V	fowxq v
T, VE	t ve
S, OMKNOT	s omknot
ULS, A	uls a
UM, KMY	um kmy
NEN, NHER	nen nher
Z, HXMJI	z hxmji
PD, A	pd a
SF, HP	sf hp
YKX, BZ	ykx bz
QSND, NLK	qsnd nlk
U, NNX	u nnx
R, SGENHZOKLNNI	r sgenhzoklnni
SLAAE, TNG	slaae tng
Y, H	y h
NTT, TG	ntt tg
ACCLE, C	accle c
H, NM	h nm
H, RWERLOI	h rwerloi
B, VIN	b vin
KGF, Y	kgf y
D, LHD	d lhd
B, XIIST	b xiist
AZQHXKN, X	azqhxkn x
PJ, HYEP	pj hyep
RO, J	ro j
C, X	c x
A, Z	a z
APSLAA, NMXEL	apslaa nmxel
WXL, FW	wxl fw
DJC, S	djc s
PQFG, ADYXHB	pqfg adyxhb
BWU, DBGFR	bwu dbgfr
NW, TO	nw to
R, T	r t
Z, CDTSWG	z cdtswg
N, ML	n ml
DGMHM, S	dgmhm s
YT, OFLON	yt oflon
BEXTLY, Y	bextly y
C, HY	c hy
OG, N	og n
ICTR, FSPB	ictr fspb
TDUG, M	tdug m
S, CIF	s cif
S, LY	s ly
X, EI	x ei
S, JPEXHVH	s jpexhvh
SV, U	sv u
UVALFOGT, V	uvalfogt v
K, W	k w
PZX, TDYO	pzx tdyo
NHUP, TM	nhup tm
Q, IO	q io
XB, UB	xb ub
C, G	c g
GBYFDV, GTG	gbyfdv gtg
A, V	a v
IP, LWA	ip lwa
U, UH	u uh
D, C	d c
W, S	w s
B, HY	b hy
R, FQL	r fql
S, STMFPA	s stmfpa
VO, Z	vo z
T, J	t j
I, IZO	i izo
T, O	t o
Y, RX	y rx
SEJQD, Q	sejqd q
U, V	u v
GKRM, P	gkrm p
EWQL, XFF	ewql xff
Y, F	y f
I, IC	i ic
ZLO, TEXC	zlo texc
UU, T	uu t
OB, QR	ob qr
J, N	j n
LR, X	lr x
RMR, DM	rmr dm
ADC, W	adc w
OZZEAL, P	ozzeal p
H, VSDM	h vsdm
B, DVD	b dvd
XNU, X	xnu x
MVR, LA	mvr la
V, AD	v ad
G, PJT	g pjt
I, X	i x
O, ZJ	o zj
J, KYE	j kye
V, K	v k
RGA, KAMIKZJ	rga kamikzj
DOD, SAFWTWE	dod safwtwe
WE, U	we u
D, UGQRVZZ	d ugqrvzz
J, PQ	j pq
EEU, WI	eeu wi
YSU, J	ysu j
YNFB, PSELRV	ynfb pselrv
V, TIG	v tig
CE, UY	ce uy
IIEZ, Y	iiez y
YDL, O	ydl o
URFD, FFZJR	urfd ffzjr
W, JEF	w jef
NKP, O	nkp o
BEUPS, YS	beups ys
V, DGFM	v dgfm
XSB, WQJJZBWOOV	xsb wqjjzbwoov
K, UM	k um
MB, B	mb b
H, M	h m
MOP, M	mop m
M, K	m k
K, XRV	k xrv
C, KB	c kb
OKVQ, BRH	okvq brh
UTOI, L	utoi l
RA, OZLJ	ra ozlj
OHDY, I	ohdy i
BNP, AULVPR	bnp aulvpr
B, DVKMG	b dvkmg
SVC, LPGWV	svc lpgwv
YM, YYI	ym yyi
YCJRF, K	ycjrf k
XN, Q	xn q
TRW, X	trw x
MXQ, V	mxq v
FA, T	fa t
B, GSYARZ	b gsyarz
AUIZQFIBFGPDT, J	auizqfibfgpdt j
K, A	k a
PPRNP, DL	pprnp dl
IKDMU, L	ikdmu l
X, C	x c
S, MTP	s mtp
C, LZFA	c lzfa
Q, Z	q z
OBR, MLQ	obr mlq
D, ELG	d elg
C, L	c l
W, WVESA	w wvesa
ZHZMU, Q	zhzmu q
M, X	m x
XBGROY, PEIXYRD	xbgroy peixyrd
N, KC	n kc
F, V	f v
N, DYD	n dyd
F, MRF	f mrf
F, BU	f bu
Z, TBCCIKQB	z tbccikqb
NEK, FLNNTI	nek flnnti
V, JP	v jp
ND, T	nd t
EC, EL	ec el
YL, FQI	yl fqi
XQL, TRK	xql trk
LCTH, BU	lcth bu
JVLBRH, V	jvlbrh v
A, V	a v
YX, RXXJ	yx rxxj
A, JMBN	a jmbn
T, L	t l
HP, X	hp x
GDMHW, TP	gdmhw tp
A, DYJ	a dyj
RTIM, MG	rtim mg
YM, OKBLK	ym okblk
XM, W	xm w
XW, S	xw s
A, H	a h
GPBQZY, RX	gpbqzy rx
VQ, M	vq m
A, DDVPYR	a ddvpyr
SK, ZWVU	sk zwvu
S, PP	s pp
D, HNZ	d hnz
Q, Q	q q
V, HZX	v hzx
Z, JVKXE	z jvkxe
C, BD	c bd
IDH, T	idh t
Q, LN	q ln
KR, UBKVJ	kr ubkvj
CJDF, S	cjdf s
BXE, UE	bxe ue
D, U	d u
COJ, Y	coj y
JFP, U	jfp u
DOD, QD	dod qd
Z, SX	z sx
WFLQT, E	wflqt e
L, L	l l
S, L	s l
SZQTYDRTJ, S	szqtydrtj s
K, DASZIBTCQO	k daszibtcqo
L, P	l p
I, N	i n
Q, C	q c
CKJYR, N	ckjyr n
W, ZNE	w zne
W, GG	w gg
ZVYF, UGHJQP	zvyf ughjqp
PB, D	pb d
Q, R	q r
MFUQ, U	mfuq u
LVRWRNXUYLYI, Y	lvrwrnxuylyi y
I, VRU	i vru
CNQ, YE	cnq ye
ZT, CKB	zt ckb
V, K	v k
WI, LFA	wi lfa
SVAZ, CZXDA	svaz czxda
A, D	a d
D, UTXC	d utxc
S, UPDH	s updh
T, PL	t pl
JQM, CE	jqm ce
P, K	p k
IU, O	iu o
FE, A	fe a
UWGU, FV	uwgu fv
JYZXLXJ, J	jyzxlxj j
Y, XHDM	y xhdm
IHSQJBN, V	ihsqjbn v
RDANNRI, V	rdannri v
A, QX	a qx
IW, NL	iw nl
T, B	t b
VMVLC, IYJYG	vmvlc iyjyg
U, LQR	u lqr
M, Y	m y
H, KJB	h kjb
ZYN, K	zyn k
WR, Q	wr q
COG, OPHMXO	cog ophmxo
U, I	u i
FHSSQCB, V	fhssqcb v
BBSZ, FCU	bbsz fcu
A, OGCJ	a ogcj
BQJTU, OQS	bqjtu oqs
O, J	o j
KT, ZL	kt zl
CNVN, A	cnvn a
DXK, MFQ	dxk mfq
S, ZQ	s zq
FQMK, X	fqmk x
RXNJX, SUP	rxnjx sup
PY, YJ	py yj
FOM, OQ	fom oq
V, EIW	v eiw
X, GCD	x gcd
CUO, T	cuo t
YJQ, JFQF	yjq jfqf
DD, MX	dd mx
DQPU, XMF	dqpu xmf
TOZ, OGS	toz ogs
V, YZ	v yz
RG, F	rg f
COXF, YKV	coxf ykv
B, FZ	b fz
UD, XTX	ud xtx
TQ, PYNOW	tq pynow
P, YXP	p yxp
SK, B	sk b
IZ, XF	iz xf
ZHNJ, XOP	zhnj xop
PN, ID	pn id
TE, W	te w
VA, NRTKAK	va nrtkak
I, I	i i
RU, T	ru t
T, DE	t de
H, FZT	h fzt
H, NU	h nu
W, XKGYO	w xkgyo
Z, GPIJUB	z gpijub
AG, HMPRWA	ag hmprwa
S, RBNR	s rbnr
H, WW	h ww
NIK, SS	nik ss
G, E	g e
AUF, PUYX	auf puyx
A, J	a j
EBA, EWW	eba eww
T, J	t j
K, CQ	k cq
U, G	u g
WOUA, NQ	woua nq
UYI, AE	uyi ae
JASO, X	jaso x
DOMW, DPILA	domw dpila
OL, MFFJFV	ol mffjfv
L, CV	l cv
V, SZ	v sz
Z, YSI	z ysi
RZAE, O	rzae o
I, MP	i mp
N, GK	n gk
OS, F	os f
A, P	a p
SHJFSW, RUW	shjfsw ruw
D, CPV	d cpv
DG, J	dg j
K, G	k g
WSA, SYG	wsa syg
W, B	w b
TD, CAS	td cas
QMN, UZ	qmn uz
X, L	x l
GZG, S	gzg s
GLA, TWRFBN	gla twrfbn
EZPE, V	ezpe v
EWRLHR, IE	ewrlhr ie
GGXFQN, N	ggxfqn n
FUHOOK, ZWM	fuhook zwm
RF, L	rf l
CSN, HYIW	csn hyiw
L, LDVLHGZCK	l ldvlhgzck
V, MBJ	v mbj
KTWX, IF	ktwx if
PZIOF, C	pziof c
IC, JXG	ic jxg
VIOE, X	vioe x
R, HZ	r hz
XMQ, B	xmq b
S, YFG	s yfg
M, O	m o
HGVQS, DHYG	hgvqs dhyg
O, LN	o ln
J, DD	j dd
MI, C	mi c
CZR, QN	czr qn
M, M	m m
AY, GAF	ay gaf
XH, TYS	xh tys
GQ, CPX	gq cpx
IVI, OOH	ivi ooh
JEXN, C	jexn c
A, Z	a z
T, N	t n
TNG, ZR	tng zr
GX, LQR	gx lqr
O, KAI	o kai
A, AF	a af
KP, DSJI	kp dsji
B, R	b r
UOBSBIYC, UU	uobsbiyc uu
TYXSM, WL	tyxsm wl
E, N	e n
H, XGJ	h xgj
Y, FPF	y fpf
POLDE, F	polde f
TLWNBNY, S	tlwnbny s
Y, D	y d
T, ALY	t aly
J, R	j r
VF, UEJNEO	vf uejneo
N, YSC	n ysc
DMBT, KSL	dmbt ksl
DN, ZIQQO	dn ziqqo
XNT, QR	xnt qr
H, LPFUBL	h lpfubl
UI, HOEKE	ui hoeke
UX, P	ux p
AHF, HT	ahf ht
RB, DG	rb dg
K, EN	k en
TH, O	th o
DX, Q	dx q
J, UDUKB	j udukb
KJ, DAIR	kj dair
U, ZOY	u zoy
NCQUI, US	ncqui us
J, BEYZ	j beyz
ZD, CCI	zd cci
RBWDB, IJZOQ	rbwdb ijzoq
I, DECI	i deci
SMQ, KE	smq ke
VO, D	vo d
Y, QY	y qy
G, C	g c
S, YFV	s yfv
F, MGFE	f mgfe
LHVM, W	lhvm w
GV, T	gv t
P, VGBHYYRBB	p vgbhyyrbb
SV, Q	sv q
FEYPLV, GSTK	feyplv gstk
V, M	v m
JYPMDDA, WTLH	jypmdda wtlh
YJL, W	yjl w
W, F	w f
LS, JV	ls jv
UDRTN, WDOO	udrtn wdoo
HLKTW, W	hlktw w
CC, N	cc n
X, ZM	x zm
I, EL	i el
Q, IC	q ic
XT, ULF	xt ulf
WJ, VIHUQG	wj vihuqg
ZDV, BY	zdv by
G, YXMVG	g yxmvg
TTJ, K	ttj k
PTG, F	ptg f
P, LLXH	p llxh
BIXZBTM, DO	bixzbtm do
DENK, KGFBGAAULN	denk kgfbgaauln
R, B	r b
DR, IZ	dr iz
O, OG	o og
HZUGJ, E	hzugj e
A, Z	a z
F, C	f c
RXC, QMK	rxc qmk
V, A	v a
MKTW, E	mktw e
YK, O	yk o
BF, FLL	bf fll
H, D	h d
Q, RXLA	q rxla
W, VXECXT	w vxecxt
VRUP, J	vrup j
R, WAG	r wag
XEASJN, OEXEDWD	xeasjn oexedwd
G, BYN	g byn
UY, LMH	uy lmh
O, U	o u
DUIL, SY	duil sy
HCPSDJ, Y	hcpsdj y
TH, E	th e
ZRC, E	zrc e
H, G	h g
TGQPM, H	tgqpm h
LB, T	lb t
FSSP, NTWLZX	fssp ntwlzx
SIWL, TF	siwl tf
W, FXVWQTOBJ	w fxvwqtobj
X, XWHV	x xwhv
CPD, M	cpd m
T, NHILF	t nhilf
BPVQTO, KHQ	bpvqto khq
Z, VYVGA	z vyvga
ZDIK, MEYUS	zdik meyus
Z, TV	z tv
JF, NPJAEXY	jf npjaexy
QYZ, RWDJIF	qyz rwdjif
RB, T	rb t
D, P	d p
PDVPO, PMKG	pdvpo pmkg
A, UQ	a uq
O, ZDP	o zdp
PLE, L	ple l
WSV, QHO	wsv qho
R, D	r d
N, FFXC	n ffxc
VJ, MN	vj mn
GC, DOFI	gc dofi
TK, IINPXOHK	tk iinpxohk
PF, EZSLD	pf ezsld
S, JDND	s jdnd
DXG, HJ	dxg hj
UJ, ZPL	uj zpl
RDA, E	rda e
XUY, C	xuy c
K, R	k r
HOVTY, V	hovty v
XQS, ML	xqs ml
WUHOZ, MAC	wuhoz mac
QW, U	qw u
H, VHRLIKMGHPTU	h vhrlikmghptu
VK, Q	vk q
Z, A	z a
WP, HGN	wp hgn
ZV, JB	zv jb
U, I	u i
FUJM, H	fujm h
EEMWSSWRH, GM	eemwsswrh gm
IMNDPC, OPU	imndpc opu
K, KEC	k kec
RUTRJFVSLJOOJD, XF	rutrjfvsljoojd xf
RJGPJGRV, S	rjgpjgrv s
W, RVF	w rvf
ELS, D	els d
K, N	k n
X, DQS	x dqs
H, Q	h q
AWDJUY, TK	awdjuy tk
O, IU	o iu
R, B	r b
O, WMW	o wmw
VI, HBXLLGZCA	vi hbxllgzca
KM, DUZY	km duzy
UYXXT, L	uyxxt l
Z, P	z p
JUWOLSON, Q	juwolson q
GQYHPXJMV, T	gqyhpxjmv t
M, WFTM	m wftm
F, IQW	f iqw
G, NZRB	g nzrb
VOD, N	vod n
M, QG	m qg
IH, XD	ih xd
NXMQA, E	nxmqa e
SRH, HXU	srh hxu
KM, HFNONV	km hfnonv
DUD, LMCF	dud lmcf
PBY, AS	pby as
UZE, IP	uze ip
U, WX	u wx
CQ, YBWFI	cq ybwfi
EGNM, EW	egnm ew
O, BN	o bn
PRAJXPPKYLG, Y	prajxppkylg y
C, GI	c gi
WB, GU	wb gu
M, F	m f
VEQ, XBJ	veq xbj
DKI, E	dki e
IB, DVZQ	ib dvzq
HXR, O	hxr o
V, WO	v wo
LTCHPU, G	ltchpu g
M, R	m r
AM, TZXHOO	am tzxhoo
QBVCRU, GFGCVV	qbvcru gfgcvv
SWY, WCMK	swy wcmk
NU, B	nu b
UX, QEYG	ux qeyg
XE, MKOFU	xe mkofu
D, B	d b
VZ, FG	vz fg
V, NPY	v npy
T, EAMJPHHZ	t eamjphhz
XUGSNGQUNEJ, QYYRHQ	xugsngqunej qyyrhq
HMFX, HOD	hmfx hod
KASYDH, VNL	kasydh vnl
J, L	j l
BE, C	be c
RMPH, W	rmph w
U, QPA	u qpa
BCQZS, JSSACAR	bcqzs jssacar
W, N	w n
F, U	f u
OQZVGWZ, L	oqzvgwz l
WP, N	wp n
CHC, NYOPYOMQ	chc nyopyomq
R, NVXK	r nvxk
IR, MM	ir mm
O, YUPDZXHRFWU	o yupdzxhrfwu
CBOL, KA	cbol ka
KNVX, QEI	knvx qei
HE, TOR	he tor
LXB, N	lxb n
BGV, F	bgv f
SBAD, Z	sbad z
DLZIE, J	dlzie j
TJXERIL, M	tjxeril m
F, YY	f yy
LHE, JU	lhe ju
QV, R	qv r
BF, C	bf c
XBAXNCOWNW, Y	xbaxncownw y
M, Q	m q
AI, MCOHCCYUI	ai mcohccyui
EDC, MPO	edc mpo
D, DP	d dp
ER, J	er j
F, HGVKP	f hgvkp
L, DXMM	l dxmm
XF, II	xf ii
NM, T	nm t
RPFEC, UJOQD	rpfec ujoqd
DG, YM	dg ym
VAX, W	vax w
LB, V	lb v
NX, E	nx e
K, EAX	k eax
ZLFWNF, UIEHT	zlfwnf uieht
N, AOKB	n aokb
U, TV	u tv
BPVTVLJ, A	bpvtvlj a
WSPQV, IS	wspqv is
RKQZXKN, C	rkqzxkn c
FYTIVIX, HAGQGY	fytivix hagqgy
KWN, N	kwn n
W, WQT	w wqt
KI, V	ki v
EFU, D	efu d
B, L	b l
VD, FUJ	vd fuj
TCJ, EA	tcj ea
OJ, W	oj w
P, I	p i
KABNJ, MIUTZ	kabnj miutz
ZF, ZRD	zf zrd
RC, B	rc b
W, J	w j
G, X	g x
P, PKYVBTA	p pkyvbta
D, TWJYFCC	d twjyfcc
W, GM	w gm
POMOKS, ZRD	pomoks zrd
WKDV, A	wkdv a
TS, ZG	ts zg
J, KN	j kn
HKSXALVW, TEV	hksxalvw tev
Q, UUS	q uus
L, LHN	l lhn
HWM, KRUP	hwm krup
IG, UEKS	ig ueks
ZOH, OGC	zoh ogc
IMZA, PN	imza pn
XJI, LKF	xji lkf
DKC, EL	dkc el
K, LLRAS	k llras
E, J	e j
R, W	r w
K, ML	k ml
T, JWM	t jwm
V, FQ	v fq
KPOIV, YW	kpoiv yw
AV, PJMC	av pjmc
LQZZBWO, FY	lqzzbwo fy
PP, OU	pp ou
K, O	k o
FK, T	fk t
K, I	k i
EX, EWD	ex ewd
Q, VD	q vd
U, NVRWQ	u nvrwq
FLJN, V	fljn v
Q, E	q e
U, X	u x
P, KN	p kn
E, T	e t
Y, JLV	y jlv
P, TY	p ty
OODU, RSUTVLBGKM	oodu rsutvlbgkm
DNDJ, FCWC	dndj fcwc
EONISHFM, SEJ	eonishfm sej
TE, SCVT	te scvt
MZ, N	mz n
D, X	d x
LGE, JCSR	lge jcsr
TM, UFGMU	tm ufgmu
Z, HDV	z hdv
D, JR	d jr
U, F	u f
JQM, N	jqm n
V, AR	v ar
EU, U	eu u
MU, L	mu l
O, DUQ	o duq
AAXWJTG, F	aaxwjtg f
Y, YLYZWHMF	y ylyzwhmf
X, MD	x md
DB, HUK	db huk
KDM, ATDZ	kdm atdz
SYR, OJN	syr ojn
K, LFTSHW	k lftshw
UXK, Z	uxk z
I, DR	i dr
G, EFL	g efl
OT, EJROL	ot ejrol
WLF, WQLL	wlf wqll
Z, X	z x
R, W	r w
ATT, B	att b
ZUHXNJ, S	zuhxnj s
W, E	w e
OIRD, Q	oird q
S, L	s l
PG, X	pg x
IPHAD, OF	iphad of
TO, G	to g
U, N	u n
BUQPOY, F	buqpoy f
GZZDV, B	gzzdv b
HVJYP, AQZMAL	hvjyp aqzmal
AQYYN, ZH	aqyyn zh
MD, G	md g
L, CH	l ch
RU, FSRVSLWQX	ru fsrvslwqx
AIOIJL, R	aioijl r
Y, C	y c
J, O	j o
U, FPVPD	u fpvpd
GJVOYH, FGLJLLVBF	gjvoyh fgljllvbf
MY, W	my w
X, P	x p
D, CO	d co
IG, ISB	ig isb
B, DX	b dx
WZ, WUZI	wz wuzi
GCW, WRZ	gcw wrz
PUWPNVVA, TC	puwpnvva tc
OJ, J	oj j
SM, Q	sm q
EXK, JP	exk jp
Y, Z	y z
G, AA	g aa
HF, Y	hf y
PWYXP, U	pwyxp u
HUDNHQ, YTVVLQ	hudnhq ytvvlq
T, I	t i
YIB, D	yib d
Z, RI	z ri
HN, Z	hn z
IFM, L	ifm l
X, OKEQ	x okeq
J, DN	j dn
INM, FWZ	inm fwz
L, SD	l sd
EJI, LKKE	eji lkke
R, P	r p
FXY, CK	fxy ck
CBVBAH, X	cbvbah x
BBUOM, KYFV	bbuom kyfv
CW, M	cw m
EX, U	ex u
SP, F	sp f
SCB, HRJEHW	scb hrjehw
UDO, WA	udo wa
RFGCDKTZW, AWM	rfgcdktzw awm
MM, VR	mm vr
CUOAD, S	cuoad s
NNGSPAOP, SW	nngspaop sw
AC, SEVK	ac sevk
K, ND	k nd
G, OXA	g oxa
Q, TF	q tf
R, VO	r vo
HOYHRT, BI	hoyhrt bi
JSE, G	jse g
D, R	d r
EX, OOPQMSWACQUJ	ex oopqmswacquj
EG, T	eg t
OO, H	oo h
W, W	w w
U, JK	u jk
LB, D	lb d
X, YF	x yf
QXA, IM	qxa im
CGYB, WLWRJKMSDBA	cgyb wlwrjkmsdba
Q, I	q i
F, VJN	f vjn
HOO, OILG	hoo oilg
DO, E	do e
NPA, SIIZJAMLX	npa siizjamlx
BGRERLELXGVWL, JTCJ	bgrerlelxgvwl jtcj
M, CSDE	m csde
IZF, GK	izf gk
J, DG	j dg
KC, KWIV	kc kwiv
NDP, OZJ	ndp ozj
OJ, AJVS	oj ajvs
IXP, J	ixp j
C, LN	c ln
S, OE	s oe
L, S	l s
BD, Z	bd z
AJW, FZ	ajw fz
NOMKGX, W	nomkgx w
ERMCR, OJQL	ermcr ojql
G, RIHU	g rihu
WBTOSR, KQIT	wbtosr kqit
S, UZOT	s uzot
DN, CP	dn cp
U, FPD	u fpd
OT, WOT	ot wot
ELDIX, TSYV	eldix tsyv
HZI, F	hzi f
T, O	t o
VNA, VNTDR	vna vntdr
JJMBJVQN, NVTAWYZQFFXNG	jjmbjvqn nvtawyzqffxng
HCXLNVH, L	hcxlnvh l
IO, G	io g
G, P	g p
U, I	u i
Q, Z	q z
Y, EZF	y ezf
XI, SX	xi sx
WBHL, K	wbhl k
Z, QV	z qv
ZLB, C	zlb c
NFIZ, HBF	nfiz hbf
GWNJ, J	gwnj j
HWG, V	hwg v
P, K	p k
O, VF	o vf
TW, H	tw h
NJAQ, S	njaq s
NRS, NI	nrs ni
HYF, VR	hyf vr
HN, V	hn v
RDF, TQU	rdf tqu
H, NC	h nc
GF, LSWJJAX	gf lswjjax
OOH, Y	ooh y
FGGXQKW, TJCYMKHHV	fggxqkw tjcymkhhv
BZ, GAWNJ	bz gawnj
T, YZ	t yz
NTBFC, S	ntbfc s
O, RTPIJ	o rtpij
FEFZ, X	fefz x
B, ZF	b zf
DQLWGZ, A	dqlwgz a
PPJF, E	ppjf e
HOX, DKGRB	hox dkgrb
X, YJ	x yj
MES, GFQ	mes gfq
GX, RW	gx rw
E, TL	e tl
J, GARYVHHU	j garyvhhu
L, JX	l jx
W, I	w i
FFHUHKK, EJ	ffhuhkk ej
J, AYJ	j ayj
DJ, A	dj a
D, AWBY	d awby
D, Z	d z
Y, IQ	y iq
HJ, R	hj r
PB, ARFHSSVD	pb arfhssvd
P, Q	p q
DJA, W	dja w
TXL, F	txl f
SV, HI	sv hi
N, ZDV	n zdv
BAZE, DX	baze dx
ZJ, SJDO	zj sjdo
B, E	b e
OX, XD	ox xd
U, KOP	u kop
YN, I	yn i
A, K	a k
A, SNQ	a snq
Y, SJP	y sjp
X, LYATPIPJ	x lyatpipj
NT, M	nt m
DKHXD, A	dkhxd a
MAEB, U	maeb u
YA, BY	ya by
E, BXZXXX	e bxzxxx
S, SYEIU	s syeiu
Y, FL	y fl
ZJ, HDPAFSJ	zj hdpafsj
Z, M	z m
T, Z	t z
XE, MI	xe mi
ERK, KLO	erk klo
YHDG, IXU	yhdg ixu
SOHLLCHQ, VHS	sohllchq vhs
QI, D	qi d
VJUJF, PM	vjujf pm
WST, WUW	wst wuw
XN, HD	xn hd
ZK, S	zk s
NFGZS, DFQVUTOEAKHXSR	nfgzs dfqvutoeakhxsr
OYP, TTAQAJ	oyp ttaqaj
ZTWSOL, I	ztwsol i
OV, TCQOMUMG	ov tcqomumg
RL, CH	rl ch
Z, R	z r
B, C	b c
X, LM	x lm
E, T	e t
EM, KA	em ka
T, X	t x
FVE, DOWFA	fve dowfa
UNYP, Y	unyp y
LGBKAK, G	lgbkak g
FH, PH	fh ph
DRFUQ, ALO	drfuq alo
WBAE, P	wbae p
Z, KR	z kr
VG, DG	vg dg
TS, Z	ts z
D, M	d m
T, DBOZYKA	t dbozyka
ZEPGB, U	zepgb u
U, IDU	u idu
V, VYGFXD	v vygfxd
VC, UJ	vc uj
PDJ, FZAD	pdj fzad
LJO, MG	ljo mg
N, B	n b
C, HKQ	c hkq
CC, L	cc l
NSM, P	nsm p
DTDQ, ZP	dtdq zp
T, WWXRI	t wwxri
TO, X	to x
XFV, RBXR	xfv rbxr
Y, YCZ	y ycz
CFOMTH, YJYY	cfomth yjyy
DG, NJ	dg nj
SC, LJZXWQZUVPVS	sc ljzxwqzuvpvs
MP, NYCUPWBSP	mp nycupwbsp
D, J	d j
EYBIA, RAC	eybia rac
RQ, BWM	rq bwm
X, H	x h
OZUD, N	ozud n
GIQ, KR	giq kr
XV, M	xv m
LWP, I	lwp i
A, V	a v
L, D	l d
V, KRI	v kri
CNA, W	cna w
I, ASYLP	i asylp
WL, YIW	wl yiw
H, XODJ	h xodj
JFOKH, M	jfokh m
PMZZ, J	pmzz j
AGC, B	agc b
NMKO, P	nmko p
YJBKOCCKVR, QC	yjbkocckvr qc
TGDOED, XHS	tgdoed xhs
K, Q	k q
CUVAE, B	cuvae b
S, IBSTJX	s ibstjx
U, RCV	u rcv
CVRTI, I	cvrti i
H, E	h e
FY, G	fy g
QAUZ, HRIEYLQ	qauz hrieylq
I, Y	i y
WVGM, WVY	wvgm wvy
AG, FFJNC	ag ffjnc
FRW, UB	frw ub
CCPNP, JLYN	ccpnp jlyn
A, LN	a ln
HNQA, M	hnqa m
O, HOIKN	o hoikn
J, N	j n
IKI, MH	iki mh
GARTQU, QB	gartqu qb
ABGU, L	abgu l
K, POQR	k poqr
DT, HW	dt hw
UU, B	uu b
QNSFH, B	qnsfh b
US, M	us m
NSW, GE	nsw ge
HGPG, B	hgpg b
I, JY	i jy
MG, ZE	mg ze
O, MJCLA	o mjcla
B, ZV	b zv
JG, J	jg j
DOL, U	dol u
N, UH	n uh
YHXYL, OJK	yhxyl ojk
A, E	a e
IVG, ULR	ivg ulr
JBQVT, M	jbqvt m
CPH, WS	cph ws
CVPV, Z	cvpv z
BUQP, KZSZ	buqp kzsz
W, EM	w em
V, JSJX	v jsjx
LV, VB	lv vb
ES, JI	es ji
NS, E	ns e
PIJDD, DS	pijdd ds
NKWK, D	nkwk d
HHCK, U	hhck u
Z, W	z w
ZGZH, JKQEVWRGLHFCTPF	zgzh jkqevwrglhfctpf
VER, EI	ver ei
MAFN, PV	mafn pv
S, DO	s do
J, EFKH	j efkh
FZ, YY	fz yy
YD, MO	yd mo
XRH, MZ	xrh mz
GZO, L	gzo l
M, HJ	m hj
SE, TPALF	se tpalf
APNUP, ZD	apnup zd
M, GQ	m gq
D, ACFGO	d acfgo
S, YQ	s yq
N, M	n m
U, ZL	u zl
RZSYRTUP, FBSCDH	rzsyrtup fbscdh
MIPQU, QBK	mipqu qbk
P, A	p a
YPQ, NLRCFPS	ypq nlrcfps
PBUABF, GD	pbuabf gd
FQX, I	fqx i
ND, G	nd g
H, PQ	h pq
CINLQJ, Y	cinlqj y
YQD, GEX	yqd gex
DJF, QPR	djf qpr
JD, UZ	jd uz
OFM, XWXAAWJ	ofm xwxaawj
H, XUCZK	h xuczk
G, G	g g
M, ZB	m zb
MDEWP, G	mdewp g
B, BV	b bv
YPKYBK, HT	ypkybk ht
LIAU, R	liau r
AXOQGRL, RXY	axoqgrl rxy
LRXTU, GSVD	lrxtu gsvd
AU, WK	au wk
I, E	i e
UK, VNLVB	uk vnlvb
RT, O	rt o
OM, KU	om ku
KGG, S	kgg s
RC, H	rc h
GHRK, N	ghrk n
XP, K	xp k
H, LJY	h ljy
GCGWNWANE, Z	gcgwnwane z
X, QOUXVT	x qouxvt
A, O	a o
X, KMSDBO	x kmsdbo
TO, TMS	to tms
TODL, ZF	todl zf
PTZP, WKG	ptzp wkg
VSK, F	vsk f
KM, ULOO	km uloo
CXWK, U	cxwk u
Y, C	y c
S, F	s f
GCDGMAPSYTSQ, Q	gcdgmapsytsq q
U, A	u a
Y, G	y g
O, WP	o wp
A, NS	a ns
KT, F	kt f
A, V	a v
BB, M	bb m
O, O	o o
L, J	l j
OZW, II	ozw ii
KKEM, A	kkem a
WHCGN, ZV	whcgn zv
B, CF	b cf
BK, G	bk g
WC, TAVRNP	wc tavrnp
E, J	e j
BDBVOJCXHVTXZK, ONTRWFL	bdbvojcxhvtxzk ontrwfl
J, T	j t
OLLZFJ, RV	ollzfj rv
LA, SNSAW	la snsaw
L, C	l c
PG, EXEZ	pg exez
HIM, CE	him ce
CUPM, I	cupm i
XKY, ZU	xky zu
M, COD	m cod
C, ZRX	c zrx
L, F	l f
K, D	k d
C, ZNHYVQFQQGN	c znhyvqfqqgn
X, UW	x uw
K, S	k s
BK, ES	bk es
RF, KU	rf ku
RTEZ, KJVKJCW	rtez kjvkjcw
H, ZQ	h zq
RT, Y	rt y
U, G	u g
ZDR, LHZA	zdr lhza
ALGLS, UXKNC	algls uxknc
PP, P	pp p
SL, J	sl j
F, CGAKV	f cgakv
YIYVR, W	yiyvr w
UAD, LZZ	uad lzz
KP, QF	kp qf
T, CN	t cn
T, H	t h
Q, RQNZ	q rqnz
T, UAVM	t uavm
TFNZ, E	tfnz e
Z, AD	z ad
S, WLP	s wlp
YJEYC, E	yjeyc e
NKL, DP	nkl dp
T, BHH	t bhh
UIU, W	uiu w
NMC, WN	nmc wn
NYAPX, MBS	nyapx mbs
E, V	e v
K, MCFPWARJ	k mcfpwarj
HU, HT	hu ht
G, YFKMT	g yfkmt
QQCC, RJ	qqcc rj
Q, T	q t
N, JY	n jy
N, D	n d
IWNB, Q	iwnb q
BFEPHJK, W	bfephjk w
DPM, R	dpm r
YA, YTJ	ya ytj
XDO, D	xdo d
AX, KXJEKFQBNPIX	ax kxjekfqbnpix
E, F	e f
PJ, VEJG	pj vejg
ZY, KK	zy kk
WY, JQJ	wy jqj
AIJ, F	aij f
OOGXW, KBC	oogxw kbc
F, DX	f dx
X, NS	x ns
BH, KV	bh kv
V, TA	v ta
W, XX	w xx
K, WJE	k wje
O, N	o n
OZHCWKGETAVY, PWB	ozhcwkgetavy pwb
YN, GVGPB	yn gvgpb
F, IP	f ip
TQ, Z	tq z
S, JGV	s jgv
P, VUH	p vuh
SDJDQ, HISW	sdjdq hisw
OBUAR, M	obuar m
F, CDE	f cde
T, X	t x
P, Z	p z
JA, LYIN	ja lyin
XYS, U	xys u
SXP, Q	sxp q
FJN, Q	fjn q
EQ, RNAZ	eq rnaz
NRU, UZ	nru uz
CHW, V	chw v
O, BT	o bt
D, N	d n
MO, YJE	mo yje
VC, S	vc s
I, O	i o
A, JXO	a jxo
V, M	v m
V, R	v r
M, FEQG	m feqg
WOE, F	woe f
C, EFSK	c efsk
XUZ, FTDKH	xuz ftdkh
X, OJP	x ojp
MO, A	mo a
DN, I	dn i
R, LW	r lw
HGO, PMYTVHX	hgo pmytvhx
K, P	k p
H, Q	h q
JX, ORDUJY	jx ordujy
F, SE	f se
RYK, KDNJWJ	ryk kdnjwj
D, HU	d hu
M, UGE	m uge
QA, W	qa w
I, OE	i oe
JAZH, D	jazh d
LBCA, RO	lbca ro
Z, CNUVH	z cnuvh
DQII, O	dqii o
X, I	x i
GA, GIB	ga gib
S, S	s s
V, KGJ	v kgj
M, A	m a
Y, N	y n
ZL, ALN	zl aln
ZL, KLTK	zl kltk
V, A	v a
KP, KO	kp ko
D, EQ	d eq
ZAX, ZP	zax zp
XV, Y	xv y
DZXG, Z	dzxg z
SS, KGCAI	ss kgcai
HJ, LX	hj lx
S, O	s o
HV, FN	hv fn
NH, CYK	nh cyk
WQIS, I	wqis i
NGF, RXLQO	ngf rxlqo
X, O	x o
DYPZ, K	dypz k
V, L	v l
Y, DZ	y dz
V, WNWSWT	v wnwswt
OZ, EZD	oz ezd
Y, P	y p
UNODEHNELD, PB	unodehneld pb
U, NNCO	u nnco
ZU, CZSV	zu czsv
SP, GT	sp gt
WM, MOP	wm mop
B, PD	b pd
RBQXYZ, H	rbqxyz h
T, SG	t sg
P, B	p b
R, B	r b
V, DOYGI	v doygi
HM, NVVY	hm nvvy
ZXOZKPLWWEOR, P	zxozkplwweor p
CC, WG	cc wg
JB, GBF	jb gbf
C, B	c b
R, QQ	r qq
BLPS, V	blps v
PSAAJFU, HW	psaajfu hw
CI, ZDEYG	ci zdeyg
D, RIC	d ric
DZQB, RBZ	dzqb rbz
G, DP	g dp
OQMTHAPR, PF	oqmthapr pf
NF, P	nf p
AGG, IT	agg it
MY, UMH	my umh
M, R	m r
NGNW, XJJDM	ngnw xjjdm
YE, L	ye l
LI, WS	li ws
N, VGBV	n vgbv
GRZ, T	grz t
LXMD, B	lxmd b
FFQ, IBRUN	ffq ibrun
ZS, WM	zs wm
PI, N	pi n
IID, HWTB	iid hwtb
R, CY	r cy
QTW, HF	qtw hf
P, QEW	p qew
XC, D	xc d
DCMS, QS	dcms qs
F, BV	f bv
XS, JN	xs jn
IQN, UR	iqn ur
ZZ, Y	zz y
ROM, FPLQDJODPK	rom fplqdjodpk
S, CG	s cg
ZFK, H	zfk h
KCLMVOT, NUW	kclmvot nuw
ORMMSRGEOTAEM, ENW	ormmsrgeotaem enw
JMV, HDX	jmv hdx
VA, YZ	va yz
B, KYQ	b kyq
T, D	t d
NKSPCHWXDI, L	nkspchwxdi l
P, II	p ii
IC, YLKK	ic ylkk
MQ, T	mq t
P, VNFAM	p vnfam
MXSLZG, B	mxslzg b
D, VD	d vd
BK, O	bk o
QWHPV, VVJCT	qwhpv vvjct
D, HA	d ha
DXVSY, O	dxvsy o
RGYY, A	rgyy a
S, NWICY	s nwicy
LLF, P	llf p
A, L	a l
GHS, OAN	ghs oan
WP, PL	wp pl
U, G	u g
R, WOY	r woy
O, YR	o yr
P, P	p p
LMGNCO, R	lmgnco r
WS, E	ws e
N, I	n i
S, H	s h
W, M	w m
OW, OIKHH	ow oikhh
WVASX, A	wvasx a
CJX, QRI	cjx qri
MQ, CJYL	mq cjyl
OSI, F	osi f
N, U	n u
E, YZY	e yzy
STAVJFV, QYH	stavjfv qyh
E, VT	e vt
AY, SZAJL	ay szajl
EWO, LP	ewo lp
KQ, A	kq a
ZTMDURW, S	ztmdurw s
IA, N	ia n
UIB, B	uib b
I, GYCXAX	i gycxax
YU, U	yu u
F, L	f l
SWBHHOOYE, GPJAQ	swbhhooye gpjaq
CF, PVO	cf pvo
W, JL	w jl
WG, G	wg g
S, F	s f
JG, XQNILLTXFP	jg xqnilltxfp
ZCQN, KG	zcqn kg
T, D	t d
RTB, E	rtb e
IDRSWZY, X	idrswzy x
UDRLL, MG	udrll mg
CA, SRF	ca srf
XTYHY, Y	xtyhy y
WD, FZD	wd fzd
EFUGFTOTI, H	efugftoti h
U, S	u s
P, H	p h
KYI, AAA	kyi aaa
KD, KQUQTVU	kd kquqtvu
VNEV, P	vnev p
RXP, CNPMCQT	rxp cnpmcqt
B, TOD	b tod
M, R	m r
Q, PX	q px
Q, JZV	q jzv
S, F	s f
LS, Q	ls q
GRCWWZF, QBNTUPZUO	grcwwzf qbntupzuo
NKZ, Y	nkz y
D, OXQ	d oxq
SVCA, SS	svca ss
PJH, Y	pjh y
HXXWX, RUKE	hxxwx ruke
XB, BGQA	xb bgqa
QF, HL	qf hl
Q, DX	q dx
NF, WDX	nf wdx
AX, NBYDPURG	ax nbydpurg
HIOBA, KR	hioba kr
PU, VOGHF	pu voghf
GCTE, Q	gcte q
Z, Q	z q
V, YZ	v yz
A, DC	a dc
U, BK	u bk
CLQ, EB	clq eb
VWVBC, SJ	vwvbc sj
B, W	b w
PH, AOVV	ph aovv
ZWPAV, BY	zwpav by
T, N	t n
VF, U	vf u
UL, PPY	ul ppy
J, P	j p
IBX, QDY	ibx qdy
H, IRKP	h irkp
LTLV, GE	ltlv ge
YLDPGGY, TKAYV	yldpggy tkayv
T, B	t b
CAJK, DS	cajk ds
A, AZM	a azm
PPZ, PT	ppz pt
H, JX	h jx
K, T	k t
NOMP, H	nomp h
FZ, QEBOG	fz qebog
BGEE, UF	bgee uf
DG, F	dg f
K, U	k u
USGKAC, OC	usgkac oc
L, H	l h
E, JD	e jd
K, ZT	k zt
Y, J	y j
VXFL, QM	vxfl qm
NJUWYTOEWP, OHJWAD	njuwytoewp ohjwad
ZI, VCNGEIX	zi vcngeix
VBU, W	vbu w
PHQ, SZ	phq sz
FUEM, KJBMII	fuem kjbmii
VFPKQEY, W	vfpkqey w
XNA, T	xna t
DSTCL, BGQD	dstcl bgqd
GT, LFVDN	gt lfvdn
U, Y	u y
VWBOCAK, PSI	vwbocak psi
WOUA, Q	woua q
D, KTYZ	d ktyz
A, F	a f
SGKXP, FNT	sgkxp fnt
D, KWTLQ	d kwtlq
H, L	h l
WZ, TDQR	wz tdqr
RR, ZO	rr zo
SM, ZP	sm zp
CKAKWC, WF	ckakwc wf
CT, UILQSRKR	ct uilqsrkr
EB, WF	eb wf
OW, NX	ow nx
Q, O	q o
I, E	i e
QQ, KJRF	qq kjrf
V, AHGYV	v ahgyv
YFPUBE, M	yfpube m
W, QDL	w qdl
EEJ, X	eej x
OSTOU, DYNY	ostou dyny
VDDEXTQ, WT	vddextq wt
SKPGWBZJ, WGP	skpgwbzj wgp
I, F	i f
CK, P	ck p
WAL, W	wal w
NTW, O	ntw o
AMF, I	amf i
VUHY, F	vuhy f
YUQ, SMRD	yuq smrd
UJHO, K	ujho k
HDE, DOXFQG	hde doxfqg
K, RBLN	k rbln
SFNVXAMF, PK	sfnvxamf pk
TO, WP	to wp
F, MU	f mu
MHN, Q	mhn q
O, YDNI	o ydni
MSA, F	msa f
FZJ, J	fzj j
E, Y	e y
V, A	v a
LQG, T	lqg t
OT, AFUUC	ot afuuc
J, G	j g
C, YJF	c yjf
MJ, MX	mj mx
HTD, QHGZ	htd qhgz
M, KUG	m kug
M, T	m t
T, AZ	t az
CPYJLG, JF	cpyjlg jf
CQ, XEYO	cq xeyo
AS, ZY	as zy
UA, P	ua p
U, Y	u y
VMY, HRDYHALU	vmy hrdyhalu
C, E	c e
O, QJX	o qjx
M, IV	m iv
AY, C	ay c
I, W	i w
O, BK	o bk
IV, I	iv i
W, PUJE	w puje
MP, S	mp s
TAD, O	tad o
X, K	x k
XHFES, W	xhfes w
BUG, P	bug p
GOIHA, H	goiha h
Z, WIPP	z wipp
XKLFT, YO	xklft yo
YV, GKO	yv gko
N, B	n b
A, OT	a ot
HU, LD	hu ld
IKOQ, U	ikoq u
YI, Z	yi z
PUDO, PMJCJBO	pudo pmjcjbo
UBWDUYBFV, A	ubwduybfv a
POPIPCX, OK	popipcx ok
W, APG	w apg
DFN, H	dfn h
C, CQ	c cq
Q, Y	q y
R, VDW	r vdw
CVR, M	cvr m
WIB, H	wib h
N, YIDJSJ	n yidjsj
H, C	h c
S, V	s v
K, VTQ	k vtq
ZCDYJ, A	zcdyj a
AU, TO	au to
CW, TLYB	cw tlyb
HZ, B	hz b
F, NL	f nl
J, NP	j np
WA, H	wa h
TQWRTANHKK, E	tqwrtanhkk e
XFLEQ, Y	xfleq y
Z, RR	z rr
D, K	d k
T, N	t n
ETJ, S	etj s
J, QT	j qt
T, G	t g
QFDIQJ, V	qfdiqj v
ZOJ, Z	zoj z
D, ZUPJ	d zupj
JZY, TSU	jzy tsu
L, EYQ	l eyq
WV, FSWWMXT	wv fswwmxt
G, EP	g ep
IZU, KICOAAGQ	izu kicoaagq
YH, ITLG	yh itlg
V, WCK	v wck
N, HHHHBN	n hhhhbn
M, GSFOANLFI	m gsfoanlfi
X, IOLX	x iolx
K, VZ	k vz
X, ZD	x zd
UD, S	ud s
AF, F	af f
PPSHP, PKR	ppshp pkr
T, NOF	t nof
JG, DJUVSLM	jg djuvslm
DGS, XI	dgs xi
TDHOZCZGOCE, SRK	tdhozczgoce srk
W, P	w p
S, LYIH	s lyih
KPCDGU, MZIXOM	kpcdgu mzixom
LOXCV, WVHI	loxcv wvhi
YASUVAF, K	yasuvaf k
UJ, YNAVE	uj ynave
Z, SJHKLU	z sjhklu
JDC, F	jdc f
WO, NAR	wo nar
XU, XPHHB	xu xphhb
HFL, MGCXKOW	hfl mgcxkow
T, IAU	t iau
X, J	x j
Z, A	z a
F, VYA	f vya
V, RGHNW	v rghnw
NX, C	nx c
M, KETZ	m ketz
KQZVC, NS	kqzvc ns
F, DJ	f dj
FR, ZL	fr zl
N, P	n p
DXJK, M	dxjk m
PXPDVY, CYLY	pxpdvy cyly
SVQ, VL	svq vl
ADTIBZXP, JV	adtibzxp jv
S, R	s r
B, FXGYW	b fxgyw
DR, I	dr i
B, OV	b ov
AC, P	ac p
LNGYY, Y	lngyy y
CDZN, Q	cdzn q
KO, YHV	ko yhv
Y, AS	y as
S, JBVS	s jbvs
U, UTU	u utu
WCBXS, Y	wcbxs y
IHMLNHNL, T	ihmlnhnl t
KF, A	kf a
C, ZBEZG	c zbezg
CZ, F	cz f
ITY, BRXY	ity brxy
HYTE, NPV	hyte npv
TWJU, FCBRB	twju fcbrb
VPQ, R	vpq r
QIJ, N	qij n
Y, N	y n
N, NRT	n nrt
UQUNC, IW	uqunc iw
MGBL, XHH	mgbl xhh
BIRJMMS, KXDTRACVVI	birjmms kxdtracvvi
KS, AU	ks au
W, SIJ	w sij
QVVP, AS	qvvp as
XJCSLRYPAZ, HUUH	xjcslrypaz huuh
HH, X	hh x
O, UWD	o uwd
EFQW, WPEZAA	efqw wpezaa
PJJ, ER	pjj er
SJ, V	sj v
M, KID	m kid
PY, W	py w
AHL, GAVM	ahl gavm
RCQ, H	rcq h
S, ES	s es
OMX, FXG	omx fxg
H, DF	h df
AH, AKW	ah akw
SRSM, PJ	srsm pj
O, WH	o wh
ZFL, G	zfl g
FPY, E	fpy e
JEKDMYX, IH	jekdmyx ih
WODSMSGKA, KDZUHB	wodsmsgka kdzuhb
NMUG, Y	nmug y
H, I	h i
EY, RQMME	ey rqmme
N, HX	n hx
XBX, B	xbx b
K, H	k h
Y, WSFKB	y wsfkb
S, LWOU	s lwou
H, LU	h lu
B, YJG	b yjg
RNUMSWL, KSE	rnumswl kse
AX, Y	ax y
LWP, K	lwp k
TFD, FPHTU	tfd fphtu
IJ, JIA	ij jia
QTORL, Z	qtorl z
W, R	w r
HF, UWV	hf uwv
LRQ, HU	lrq hu
R, I	r i
P, ACKB	p ackb
HA, F	ha f
KDLSO, Q	kdlso q
RUO, CL	ruo cl
ZW, AXB	zw axb
L, CITOAURYQ	l citoauryq
TPKUXE, OUP	tpkuxe oup
D, V	d v
JCKRGK, U	jckrgk u
IUY, Q	iuy q
YN, SL	yn sl
EUMV, RWON	eumv rwon
OII, A	oii a
K, X	k x
C, RQB	c rqb
FZ, H	fz h
VMCYF, QQ	vmcyf qq
D, P	d p
FEMWI, CHVUA	femwi chvua
ZD, PVED	zd pved
HFJYFI, A	hfjyfi a
IAHFVS, GH	iahfvs gh
Z, BGM	z bgm
SU, B	su b
X, B	x b
RU, EHB	ru ehb
RHTK, ZLIFEQCQA	rhtk zlifeqcqa
T, AEUD	t aeud
V, BS	v bs
ADK, XI	adk xi
XWB, MF	xwb mf
GUE, C	gue c
U, YK	u yk
YOAL, WXT	yoal wxt
Y, W	y w
TM, Q	tm q
T, Y	t y
YN, T	yn t
MQ, C	mq c
JNQOWMT, R	jnqowmt r
UV, DJ	uv dj
PB, LZ	pb lz
YPP, O	ypp o
DMT, J	dmt j
ITT, R	itt r
WMSKCM, W	wmskcm w
M, Y	m y
KB, GNE	kb gne
Q, MM	q mm
T, K	t k
HB, YB	hb yb
N, H	n h
O, U	o u
DJ, JXCJD	dj jxcjd
K, AVG	k avg
MMEZ, WRL	mmez wrl
NM, NN	nm nn
FRP, HL	frp hl
G, V	g v
UCSF, YKQII	ucsf ykqii
S, NG	s ng
JRLKNOW, DBH	jrlknow dbh
QH, HIV	qh hiv
DAVT, HTFCKPE	davt htfckpe
T, F	t f
AZ, ZHBXU	az zhbxu
FWTJP, N	fwtjp n
XXEW, Y	xxew y
DDLMY, YIO	ddlmy yio
X, JR	x jr
KQ, LATXLIYVJFSDXPE	kq latxliyvjfsdxpe
H, RA	h ra
A, DCQ	a dcq
PDNTT, Z	pdntt z
SG, OUCXEUQTO	sg oucxeuqto
VGN, I	vgn i
A, HYUH	a hyuh
K, WIZKX	k wizkx
VW, I	vw i
RHHJ, JKXW	rhhj jkxw
OQT, V	oqt v
VB, RK	vb rk
DF, CS	df cs
EYJR, HQV	eyjr hqv
ZO, C	zo c
RGI, ZL	rgi zl
TGZ, QT	tgz qt
L, V	l v
F, IZLFFUS	f izlffus
V, VI	v vi
J, Z	j z
HV, Z	hv z
N, YKB	n ykb
OR, EYJ	or eyj
A, ZVZ	a zvz
PT, DG	pt dg
POGFODNJ, SFMMGBBHQLRI	pogfodnj sfmmgbbhqlri
V, XHVXL	v xhvxl
EXH, S	exh s
V, HL	v hl
CSMYMJT, YP	csmymjt yp
Z, K	z k
GBJ, A	gbj a
EK, TVTBDK	ek tvtbdk
N, YWW	n yww
P, W	p w
QYNU, J	qynu j
N, K	n k
F, ESKWJBVXSXU	f eskwjbvxsxu
DOLKRFR, F	dolkrfr f
CROFZKN, WUJ	crofzkn wuj
C, IP	c ip
I, VIK	i vik
RJGPPXO, M	rjgppxo m
V, F	v f
IGHNA, ZTJ	ighna ztj
HEV, VB	hev vb
LH, I	lh i
VS, EF	vs ef
VBSDSH, LQ	vbsdsh lq
R, LCVVOFHMAJQKRE	r lcvvofhmajqkre
E, QFJ	e qfj
UT, YZ	ut yz
I, B	i b
RWZ, I	rwz i
L, E	l e
UNF, Q	unf q
I, EGXBV	i egxbv
S, NKFPEHP	s nkfpehp
FG, L	fg l
MM, TMU	mm tmu
UKUDTDZ, UCESGQTDGD	ukudtdz ucesgqtdgd
C, KMA	c kma
RB, JWB	rb jwb
YMJCDR, WP	ymjcdr wp
LK, AK	lk ak
SZ, SF	sz sf
IGPN, ZROB	igpn zrob
NG, ZP	ng zp
QZI, X	qzi x
VAUYFIGD, C	vauyfigd c
FB, K	fb k
QZ, NKP	qz nkp
LBKGC, F	lbkgc f
QVBB, D	qvbb d
BC, B	bc b
B, QW	b qw
WD, N	wd n
FLGSXC, N	flgsxc n
VB, XH	vb xh
QRVJ, E	qrvj e
JH, U	jh u
COTQ, T	cotq t
UGYCSZ, V	ugycsz v
PXZ, G	pxz g
VBJVIBFYNGDIV, S	vbjvibfyngdiv s
SG, YOYDEQ	sg yoydeq
IZRHJ, MY	izrhj my
B, EEZ	b eez
B, P	b p
AJ, EJBTGUCX	aj ejbtgucx
Q, X	q x
H, JE	h je
WQE, NF	wqe nf
X, W	x w
XXO, DZ	xxo dz
USQ, J	usq j
AXA, ND	axa nd
HM, MN	hm mn
MP, DYZCHJCPJ	mp dyzchjcpj
BYN, JC	byn jc
PZPU, SC	pzpu sc
C, WB	c wb
XP, CKOG	xp ckog
WI, WBAJ	wi wbaj
S, MP	s mp
BQQMAB, SZLI	bqqmab szli
WTDVVKW, W	wtdvvkw w
OII, B	oii b
J, AWXEWLB	j awxewlb
C, AEIWOCZ	c aeiwocz
N, NIL	n nil
NU, LDJQS	nu ldjqs
ELDAJFTCT, U	eldajftct u
B, SHIBUJ	b shibuj
XI, YR	xi yr
Z, H	z h
LPWXA, ADAL	lpwxa adal
N, W	n w
SSTCOKBVQ, XV	sstcokbvq xv
Y, QZUYF	y qzuyf
ELDDC, SX	elddc sx
PSMJR, P	psmjr p
BFUUR, J	bfuur j
P, EIR	p eir
YXXISVYSGGT, SR	yxxisvysggt sr
PWT, R	pwt r
D, B	d b
XWIL, F	xwil f
WA, O	wa o
LVIB, Q	lvib q
P, B	p b
UGKYDZ, V	ugkydz v
FSYM, P	fsym p
CNGXAS, VGT	cngxas vgt
VPF, Q	vpf q
L, DA	l da
S, BFU	s bfu
JFSQOFV, REU	jfsqofv reu
J, INBTC	j inbtc
FL, F	fl f
ONYKTPGF, UTZP	onyktpgf utzp
A, X	a x
EI, G	ei g
IBTE, LT	ibte lt
KG, BX	kg bx
X, ZKD	x zkd
Y, F	y f
U, L	u l
TCN, RN	tcn rn
JGQCYW, DIXJ	jgqcyw dixj
CDUHOJPIW, CZBE	cduhojpiw czbe
BMM, A	bmm a
WWE, LC	wwe lc
NQZU, FV	nqzu fv
JVXD, EUMU	jvxd eumu
KD, UHDUCWVSW	kd uhducwvsw
INL, ICJCX	inl icjcx
MGHRZA, KZNKEB	mghrza kznkeb
XNIRZRM, H	xnirzrm h
N, L	n l
I, LTQGI	i ltqgi
VR, EQLJAC	vr eqljac
P, J	p j
HSFR, KLX	hsfr klx
Q, T	q t
ICW, R	icw r
WAIJD, Q	waijd q
KUC, MA	kuc ma
U, K	u k
OKX, ICH	okx ich
KGGY, OHR	kggy ohr
V, UDBR	v udbr
AFFGNWNW, IH	affgnwnw ih
KKKV, W	kkkv w
IF, JWBU	if jwbu
QJX, CEK	qjx cek
YUQ, SPRY	yuq spry
ON, S	on s
L, GTUBFS	l gtubfs
L, G	l g
O, D	o d
SS, R	ss r
LVBN, J	lvbn j
WHI, N	whi n
I, AW	i aw
T, S	t s
UP, VTQ	up vtq
PK, O	pk o
H, BJ	h bj
UGEKCTZ, N	ugekctz n
RTH, J	rth j
DE, UO	de uo
O, W	o w
SXBQE, L	sxbqe l
XCCIADY, PW	xcciady pw
SN, EM	sn em
SKUV, RDRYTGH	skuv rdrytgh
H, E	h e
Y, S	y s
VRR, LH	vrr lh
L, U	l u
R, D	r d
KGTL, F	kgtl f
Q, SR	q sr
UJUZOZ, SRIQ	ujuzoz sriq
KUTEDU, QO	kutedu qo
R, EIC	r eic
FH, F	fh f
Z, A	z a
PA, OO	pa oo
LX, J	lx j
B, VE	b ve
X, FQWOAC	x fqwoac
TL, WBPD	tl wbpd
KYE, WZUUYNV	kye wzuuynv
F, EJ	f ej
Y, GD	y gd
LK, GKQRV	lk gkqrv
PRMF, W	prmf w
P, DL	p dl
P, NQZC	p nqzc
F, PO	f po
M, I	m i
A, TBN	a tbn
HDSHHLBZZRIXCQ, O	hdshhlbzzrixcq o
FWC, ELJ	fwc elj
LF, ED	lf ed
Q, CC	q cc
JP, EAJ	jp eaj
S, D	s d
YGS, AIN	ygs ain
T, ED	t ed
ABRYZMGB, UO	abryzmgb uo
DCF, CTWV	dcf ctwv
VKIQWPBI, O	vkiqwpbi o
ZG, E	zg e
DG, ZFQ	dg zfq
E, GF	e gf
QIXV, IA	qixv ia
P, GB	p gb
WJO, BB	wjo bb
H, IC	h ic
XXEK, JGTR	xxek jgtr
V, N	v n
N, Z	n z
MBE, AMNXP	mbe amnxp
OO, KVGM	oo kvgm
EAN, YHMRJ	ean yhmrj
F, SCXIE	f scxie
UDCSBCV, E	udcsbcv e
H, ZCV	h zcv
GF, ECE	gf ece
NZIL, W	nzil w
JY, QLAJ	jy qlaj
XACVOJQPLT, Z	xacvojqplt z
Y, A	y a
U, X	u x
K, DVZ	k dvz
OGPOKJNT, HS	ogpokjnt hs
KK, Q	kk q
C, POFXALEK	c pofxalek
DVNDC, ILX	dvndc ilx
WMG, KDB	wmg kdb
VK, BF	vk bf
LDDMZ, V	lddmz v
CBP, DL	cbp dl
CO, P	co p
U, HS	u hs
L, MACMGR	l macmgr
O, LP	o lp
LCQ, ZH	lcq zh
I, Z	i z
C, EX	c ex
GHZQ, HJ	ghzq hj
KZEBO, J	kzebo j
TTZ, V	ttz v
MU, XFYZ	mu xfyz
XWNX, WY	xwnx wy
IQM, F	iqm f
O, X	o x
C, L	c l
R, TP	r tp
TGGOXRD, TWT	tggoxrd twt
HN, KVFZ	hn kvfz
ZF, B	zf b
NGZ, L	ngz l
EG, WN	eg wn
O, UNU	o unu
YP, IWWOJQALMWRY	yp iwwojqalmwry
D, LAPMBYJEGRPDKYKH	d lapmbyjegrpdkykh
C, E	c e
S, B	s b
NQHB, WYHF	nqhb wyhf
DIX, T	dix t
T, A	t a
D, QT	d qt
VQ, YV	vq yv
CQ, F	cq f
H, K	h k
IX, TP	ix tp
J, AOX	j aox
JNQBUK, ISODF	jnqbuk isodf
UYK, DOEF	uyk doef
K, B	k b
I, G	i g
X, NT	x nt
KMD, X	kmd x
NYEIW, TG	nyeiw tg
PK, Z	pk z
TX, N	tx n
FQ, CPR	fq cpr
E, K	e k
P, BS	p bs
V, M	v m
V, ACE	v ace
NFOG, U	nfog u
WYJH, IFJ	wyjh ifj
HW, ENE	hw ene
QPER, QLIWNRTECV	qper qliwnrtecv
I, OYIQCA	i oyiqca
CQXLM, Y	cqxlm y
CFTKOEZUH, NYB	cftkoezuh nyb
QRJJ, S	qrjj s
IK, JKK	ik jkk
E, ID	e id
BC, W	bc w
CWZ, NO	cwz no
O, GG	o gg
N, QK	n qk
BAR, YI	bar yi
QHM, W	qhm w
J, E	j e
KJ, MK	kj mk
Z, MDIKWLMTMN	z mdikwlmtmn
TM, R	tm r
XJKW, NB	xjkw nb
VNE, L	vne l
ML, MISBHRGQ	ml misbhrgq
Q, Y	q y
L, L	l l
KN, XY	kn xy
SY, GSMP	sy gsmp
T, VKJ	t vkj
DE, EU	de eu
R, OR	r or
NUIRBM, UO	nuirbm uo
PL, W	pl w
H, TV	h tv
B, W	b w
P, CTT	p ctt
B, DQ	b dq
NZZ, F	nzz f
Q, GC	q gc
Z, DZ	z dz
KFM, LO	kfm lo
L, RO	l ro
SDAAUGO, BS	sdaaugo bs
AI, NWB	ai nwb
Q, KE	q ke
EL, OUS	el ous
QMIMQ, X	qmimq x
I, GLXIIRYMXO	i glxiirymxo
PMH, CU	pmh cu
FBS, E	fbs e
M, OXLALA	m oxlala
CFLYY, VU	cflyy vu
R, FEL	r fel
Y, MJJ	y mjj
ZUAOO, D	zuaoo d
FL, GB	fl gb
GGGKCAXQE, R	gggkcaxqe r
LVMQ, P	lvmq p
MCQM, MPIVO	mcqm mpivo
JV, GMXUCGS	jv gmxucgs
H, TRDYJ	h trdyj
E, ODIKWWCXXLOMEOW	e odikwwcxxlomeow
O, I	o i
Y, EGNS	y egns
FIKUW, HSB	fikuw hsb
OTYTA, NFJAAXUD	otyta nfjaaxud
JCH, PLK	jch plk
N, A	n a
H, UDARKK	h udarkk
NFM, Q	nfm q
PYNN, HY	pynn hy
XFWA, OTXSEB	xfwa otxseb
LP, IF	lp if
G, L	g l
N, IXV	n ixv
S, Z	s z
RMOW, T	rmow t
GOVE, C	gove c
Q, V	q v
M, CUYFM	m cuyfm
TVGYJ, WTE	tvgyj wte
H, JZCZSUW	h jzczsuw
R, E	r e
ZSYRT, YH	zsyrt yh
N, DZ	n dz
GQPT, SI	gqpt si
E, MDKL	e mdkl
Y, F	y f
BL, YZ	bl yz
Q, US	q us
W, B	w b
UIU, UNIIF	uiu uniif
NDZ, C	ndz c
UGEF, AU	ugef au
DGI, ANKCLK	dgi ankclk
DR, OBE	dr obe
LBXDC, F	lbxdc f
F, A	f a
S, FB	s fb
WE, UFR	we ufr
S, S	s s
F, L	f l
GM, J	gm j
VXZ, FX	vxz fx
VTWAO, Q	vtwao q
DBQ, GFA	dbq gfa
EXQ, QFU	exq qfu
GF, PB	gf pb
R, OCIL	r ocil
GLDU, GETL	gldu getl
I, X	i x
IAL, YM	ial ym
SQ, EDIZU	sq edizu
VH, PLB	vh plb
LXK, RWV	lxk rwv
DV, RK	dv rk
ZC, ZFBRWSJI	zc zfbrwsji
SG, O	sg o
DQFA, T	dqfa t
SZI, PE	szi pe
T, X	t x
SFT, M	sft m
Q, JURUP	q jurup
H, OWVA	h owva
M, U	m u
YD, LF	yd lf
QBE, Q	qbe q
W, JXW	w jxw
O, OPQ	o opq
M, E	m e
TEV, IB	tev ib
OUIKENJS, QWF	ouikenjs qwf
FXL, D	fxl d
V, QBIWSY	v qbiwsy
AUHO, USOZCCNLD	auho usozccnld
XL, O	xl o
H, X	h x
VK, ZCXQ	vk zcxq
AMUMCQ, JUX	amumcq jux
F, Q	f q
GM, CWLV	gm cwlv
J, THTZ	j thtz
YI, P	yi p
YHLMPMV, K	yhlmpmv k
PAUE, XEMR	paue xemr
SJ, G	sj g
V, W	v w
MJ, I	mj i
GQNYJR, V	gqnyjr v
LCB, E	lcb e
JS, D	js d
O, NM	o nm
PMI, UIBVXNN	pmi uibvxnn
V, GKV	v gkv
FOWI, B	fowi b
PDMI, P	pdmi p
CBWDXQK, BMYT	cbwdxqk bmyt
QIX, ZYS	qix zys
EYLLO, PQVVQ	eyllo pqvvq
I, BLCREZP	i blcrezp
U, YN	u yn
AP, C	ap c
Y, I	y i
M, EG	m eg
S, UE	s ue
QVZ, TN	qvz tn
E, I	e i
HP, FS	hp fs
QFQ, JW	qfq jw
RTXH, DKD	rtxh dkd
OKL, A	okl a
QTZ, J	qtz j
U, P	u p
BL, S	bl s
PF, QSF	pf qsf
J, L	j l
TQRCDY, HR	tqrcdy hr
W, T	w t
L, IA	l ia
OG, K	og k
SNWNKMH, LCP	snwnkmh lcp
Z, N	z n
SOLHKQO, G	solhkqo g
W, G	w g
DLTPIPX, Z	dltpipx z
UT, J	ut j
FZJB, P	fzjb p
WI, DO	wi do
O, O	o o
MIHC, CF	mihc cf
NH, PTN	nh ptn
HDSSK, PAV	hdssk pav
N, O	n o
K, OCM	k ocm
YK, Y	yk y
U, RG	u rg
NVITJI, IJE	nvitji ije
G, V	g v
Y, D	y d
QCQ, AN	qcq an
C, RMJMF	c rmjmf
ZFT, V	zft v
A, XV	a xv
Q, JURSK	q jursk
KGWT, CII	kgwt cii
SH, C	sh c
DED, SD	ded sd
EPESF, MJQGO	epesf mjqgo
RSK, U	rsk u
K, LN	k ln
NCDXUQ, JA	ncdxuq ja
SWQH, BWS	swqh bws
IKJ, SR	ikj sr
HR, D	hr d
ER, WI	er wi
H, CP	h cp
ADHWQS, H	adhwqs h
H, TRF	h trf
EVJ, ZXGBLN	evj zxgbln
X, V	x v
U, Z	u z
EIZ, Q	eiz q
H, AE	h ae
PXWH, QC	pxwh qc
GL, HFJE	gl hfje
WI, PZ	wi pz
PGFORB, QYUUX	pgforb qyuux
M, KZ	m kz
CUPXERQP, WU	cupxerqp wu
RI, GCC	ri gcc
FIOJ, OM	fioj om
AWAM, C	awam c
PCHRR, ZQ	pchrr zq
V, CYZ	v cyz
PBO, NR	pbo nr
HIUU, G	hiuu g
J, DSXR	j dsxr
VORZKUJ, G	vorzkuj g
O, ZPGK	o zpgk
V, IA	v ia
EMFX, X	emfx x
RWLT, TC	rwlt tc
BI, IPA	bi ipa
K, E	k e
VZK, V	vzk v
EZJX, QPRST	ezjx qprst
AUXNZ, HG	auxnz hg
I, XD	i xd
Z, O	z o
S, W	s w
J, Q	j q
GWT, NS	gwt ns
MRZGX, KG	mrzgx kg
XMYCK, K	xmyck k
NOU, BYYWJUQY	nou byywjuqy
E, DM	e dm
T, U	t u
ID, LZ	id lz
U, J	u j
S, N	s n
X, N	x n
FOXXUFMV, G	foxxufmv g
WK, A	wk a
UGT, WMUS	ugt wmus
P, HFZ	p hfz
HW, Q	hw q
HMCIA, O	hmcia o
KHT, FNCWF	kht fncwf
Z, PQ	z pq
X, OX	x ox
TJ, A	tj a
R, D	r d
R, YV	r yv
XJZ, KSMVSVEHQR	xjz ksmvsvehqr
SCQM, P	scqm p
PY, I	py i
VAPXO, WOGA	vapxo woga
TSIA, Q	tsia q
EQP, E	eqp e
T, M	t m
DBS, EM	dbs em
M, D	m d
T, TPPH	t tpph
K, SE	k se
JUZ, VW	juz vw
T, T	t t
B, THWJTZC	b thwjtzc
YKRO, I	ykro i
J, OW	j ow
MKN, C	mkn c
DL, A	dl a
JW, HNSJT	jw hnsjt
Y, DPX	y dpx
XOI, WT	xoi wt
JF, TJ	jf tj
MW, E	mw e
SZ, BNVAMZT	sz bnvamzt
YFJ, M	yfj m
F, KQ	f kq
T, N	t n
IUUC, CVPNS	iuuc cvpns
X, P	x p
S, EP	s ep
PS, M	ps m
GLHNZI, YOY	glhnzi yoy
GCEQXZ, O	gceqxz o
GLAQ, DEN	glaq den
WWSVKN, Y	wwsvkn y
DWF, WF	dwf wf
MBO, HHK	mbo hhk
T, ZIYJNTHW	t ziyjnthw
YZT, LOX	yzt lox
SXKV, SQUJYWO	sxkv squjywo
MPEC, B	mpec b
BC, N	bc n
ZV, DLFWZCC	zv dlfwzcc
KJ, EFAP	kj efap
ERRHZJVC, ORRBBB	errhzjvc orrbbb
IZSU, IRI	izsu iri
M, VO	m vo
I, BP	i bp
ELJ, K	elj k
E, E	e e
P, C	p c
IYJONX, WDU	iyjonx wdu
PABP, OG	pabp og
AS, LF	as lf
P, U	p u
GUCYB, Y	gucyb y
HI, QN	hi qn
IL, A	il a
I, MHA	i mha
HVS, FRNYV	hvs frnyv
T, HCLJ	t hclj
UG, Y	ug y
QL, VU	ql vu
CSX, OPI	csx opi
A, J	a j
NXPZTAD, KGZR	nxpztad kgzr
Y, IJKFEOYA	y ijkfeoya
HP, T	hp t
FFRK, KRXV	ffrk krxv
AZFR, QFAQ	azfr qfaq
TUV, RTH	tuv rth
VV, N	vv n
V, IT	v it
KC, M	kc m
WJY, NE	wjy ne
E, C	e c
Y, HH	y hh
JW, LRNF	jw lrnf
WL, S	wl s
WZ, J	wz j
F, G	f g
LMSO, O	lmso o
OOD, S	ood s
V, NWQ	v nwq
WW, S	ww s
IMZ, GX	imz gx
F, ACG	f acg
XWT, W	xwt w
FK, CEEX	fk ceex
O, Z	o z
AV, LZEOMLRBJGID	av lzeomlrbjgid
O, M	o m
Y, T	y t
JK, NM	jk nm
OL, DWYUFFA	ol dwyuffa
B, Z	b z
EGBFY, YOTS	egbfy yots
XAVYG, S	xavyg s
L, BT	l bt
A, QOZOID	a qozoid
ITJU, ARJFW	itju arjfw
Y, FATT	y fatt
EFNA, PA	efna pa
QQQTA, Z	qqqta z
S, X	s x
E, EHN	e ehn
VP, HV	vp hv
AAM, QUU	aam quu
RKLA, I	rkla i
S, YA	s ya
YU, DZYY	yu dzyy
V, B	v b
T, ZBM	t zbm
MDZJOGZVQ, E	mdzjogzvq e
DE, HT	de ht
AO, FRYP	ao fryp
R, C	r c
KHM, V	khm v
CK, XY	ck xy
ND, C	nd c
D, TAN	d tan
C, Z	c z
BRCO, ZS	brco zs
Q, UP	q up
JK, AJI	jk aji
DH, G	dh g
L, NM	l nm
XXVXC, L	xxvxc l
IT, TJ	it tj
S, AA	s aa
GWW, TRZDGJ	gww trzdgj
A, IUQI	a iuqi
MHR, UG	mhr ug
WFUPX, BGHT	wfupx bght
GRYG, D	gryg d
Y, E	y e
C, NWL	c nwl
ZZ, ON	zz on
PL, P	pl p
WU, EIF	wu eif
MKL, OM	mkl om
JJER, SW	jjer sw
ECT, IAKRZ	ect iakrz
W, PR	w pr
B, HY	b hy
WG, CPM	wg cpm
BFAI, BWXU	bfai bwxu
C, BQXWUQ	c bqxwuq
Q, F	q f
V, QYDA	v qyda
Q, S	q s
O, Q	o q
EXJTZCP, D	exjtzcp d
KT, B	kt b
K, D	k d
X, D	x d
KXD, O	kxd o
NF, X	nf x
X, S	x s
UPJZMR, D	upjzmr d
K, LJ	k lj
M, WO	m wo
P, ELLYK	p ellyk
P, ULTGINBMZR	p ultginbmzr
VBKHXO, FVG	vbkhxo fvg
SRT, U	srt u
E, YZK	e yzk
NC, K	nc k
AU, UXU	au uxu
D, GANAUYPU	d ganauypu
ZZ, R	zz r
NIZG, IS	nizg is
JSIG, Y	jsig y
S, I	s i
IH, F	ih f
O, AL	o al
GY, Y	gy y
UZZ, P	uzz p
T, GHA	t gha
EE, TAU	ee tau
C, N	c n
RF, JH	rf jh
DJ, G	dj g
B, TW	b tw
Z, SY	z sy
N, XMOBOV	n xmobov
HN, SRRF	hn srrf
V, TM	v tm
JO, YME	jo yme
L, ZC	l zc
N, W	n w
L, YV	l yv
A, OTQK	a otqk
EW, FG	ew fg
UB, CK	ub ck
EHE, X	ehe x
UBGNC, JET	ubgnc jet
IGEV, IQ	igev iq
Z, Z	z z
QH, WFL	qh wfl
WFWVLLM, EJVSVK	wfwvllm ejvsvk
CY, QI	cy qi
BXM, ABYYH	bxm abyyh
BS, US	bs us
R, X	r x
XN, G	xn g
WY, GJI	wy gji
DCSPRYN, XJYG	dcspryn xjyg
W, CCDW	w ccdw
X, Z	x z
C, OB	c ob
K, J	k j
C, MIWG	c miwg
V, B	v b
FO, UBR	fo ubr
X, P	x p
NXTPXLKUF, AR	nxtpxlkuf ar
L, V	l v
WAR, NGJK	war ngjk
XCEB, G	xceb g
B, I	b i
YS, W	ys w
YGE, GXW	yge gxw
W, WJGT	w wjgt
VB, UX	vb ux
BDPHQEMA, Q	bdphqema q
NC, MU	nc mu
EWQ, X	ewq x
Y, BM	y bm
BAF, D	baf d
WM, E	wm e
CS, W	cs w
VG, ED	vg ed
S, W	s w
N, ZZYUO	n zzyuo
A, JSB	a jsb
IFE, NF	ife nf
D, EA	d ea
Y, Z	y z
S, W	s w
K, N	k n
J, Z	j z
HWBOSAU, FB	hwbosau fb
TM, E	tm e
OQFT, K	oqft k
HUXY, L	huxy l
AG, DTLC	ag dtlc
IQI, P	iqi p
ZWRSEO, CV	zwrseo cv
L, LDWDJ	l ldwdj
YF, H	yf h
R, MGCU	r mgcu
RSQS, VD	rsqs vd
J, KNACRE	j knacre
GZFUD, X	gzfud x
WOU, PG	wou pg
N, Z	n z
KW, I	kw i
PR, WNFV	pr wnfv
G, B	g b
V, TGBB	v tgbb
U, S	u s
S, FJ	s fj
MMPRLPAP, SUAY	mmprlpap suay
NCKPQ, SPGWRH	nckpq spgwrh
QALLK, I	qallk i
G, D	g d
A, WT	a wt
O, UML	o uml
S, X	s x
USC, BQ	usc bq
J, AIP	j aip
VOM, W	vom w
A, PK	a pk
H, TQLY	h tqly
AIEY, W	aiey w
JIHC, CV	jihc cv
OO, KUJ	oo kuj
XR, QD	xr qd
OXCBW, UZCX	oxcbw uzcx
AKN, UME	akn ume
B, SKOVT	b skovt
BNU, KF	bnu kf
KL, IDA	kl ida
X, X	x x
PFY, F	pfy f
E, Y	e y
BHTU, AQ	bhtu aq
YT, OUS	yt ous
X, SE	x se
O, DVHHB	o dvhhb
Z, YB	z yb
Q, LS	q ls
PG, TRI	pg tri
HA, YG	ha yg
JCHCXBUGTMMHTUYWRW, Q	jchcxbugtmmhtuywrw q
C, WNK	c wnk
GVNFA, ZJ	gvnfa zj
X, TFD	x tfd
EK, OX	ek ox
R, W	r w
PBK, M	pbk m
A, W	a w
L, J	l j
PQC, B	pqc b
W, LBI	w lbi
P, M	p m
I, X	i x
EWUC, YRDJD	ewuc yrdjd
D, R	d r
WB, RM	wb rm
J, OOEF	j ooef
WAPIWRYH, PJKB	wapiwryh pjkb
C, ZS	c zs
VEHWHKQ, YI	vehwhkq yi
SDNPAVDF, YHVA	sdnpavdf yhva
LA, PASY	la pasy
C, O	c o
LGAFUR, H	lgafur h
KO, PKFPHAK	ko pkfphak
SXA, M	sxa m
GKBE, UZOPJRFY	gkbe uzopjrfy
VK, XK	vk xk
L, OSA	l osa
YHHLRW, HJW	yhhlrw hjw
BSE, F	bse f
KVC, FWMY	kvc fwmy
H, RR	h rr
O, C	o c
YI, Z	yi z
Z, VUUQ	z vuuq
T, RLV	t rlv
V, U	v u
A, L	a l
NE, E	ne e
BR, R	br r
AOSLWY, FWELMB	aoslwy fwelmb
DRVQWV, BD	drvqwv bd
P, F	p f
R, Q	r q
PNI, SXV	pni sxv
MOF, D	mof d
A, FSJT	a fsjt
TAQ, O	taq o
C, QR	c qr
VY, NPB	vy npb
ZE, M	ze m
YMNW, V	ymnw v
L, EN	l en
Y, US	y us
BK, ZB	bk zb
H, UTQP	h utqp
K, HBY	k hby
H, KUGD	h kugd
BR, BWJFMSEPS	br bwjfmseps
COZ, Z	coz z
FXYAQD, IV	fxyaqd iv
JPZ, QX	jpz qx
C, MZFNC	c mzfnc
J, C	j c
X, R	x r
MRZ, OLA	mrz ola
P, DIJN	p dijn
U, KP	u kp
EG, ID	eg id
KI, WKPT	ki wkpt
C, G	c g
LIZ, PH	liz ph
Y, WT	y wt
L, W	l w
DTJ, Q	dtj q
M, VO	m vo
MFY, RR	mfy rr
R, XRC	r xrc
X, L	x l
OJCFO, UAPTOB	ojcfo uaptob
N, O	n o
D, V	d v
YYJ, PH	yyj ph
T, VMF	t vmf
X, RGR	x rgr
MMQ, KWQUB	mmq kwqub
DQ, W	dq w
R, YXZTJIDF	r yxztjidf
Z, CQ	z cq
ASUC, FX	asuc fx
WLWXK, RX	wlwxk rx
R, A	r a
HX, H	hx h
SQNG, KBYO	sqng kbyo
X, DK	x dk
UM, GBRTDT	um gbrtdt
CNDU, MBW	cndu mbw
WJSW, UX	wjsw ux
XN, W	xn w
H, UM	h um
CSXUE, J	csxue j
ST, J	st j
C, JMNR	c jmnr
D, S	d s
YD, DWV	yd dwv
ABN, BK	abn bk
CLSA, TEL	clsa tel
T, EVLWP	t evlwp
L, BDX	l bdx
FG, V	fg v
CGFWODCN, G	cgfwodcn g
HFW, LMRX	hfw lmrx
O, R	o r
CG, P	cg p
UW, HTL	uw htl
NV, X	nv x
U, P	u p
GX, JMLDLC	gx jmldlc
T, CCZ	t ccz
H, HFV	h hfv
HS, X	hs x
N, NRALYC	n nralyc
UUG, L	uug l
QSKXVTZS, IQ	qskxvtzs iq
YT, W	yt w
X, TB	x tb
MQEQW, VV	mqeqw vv
O, J	o j
RPZ, P	rpz p
H, Q	h q
BMX, GGMHRQZU	bmx ggmhrqzu
WP, TX	wp tx
MJP, CHBO	mjp chbo
SS, Z	ss z
NQKZ, L	nqkz l
Y, Q	y q
N, BMI	n bmi
S, PUDG	s pudg
Y, D	y d
PH, F	ph f
SBXXFS, GLJB	sbxxfs gljb
OHIKXO, NUMV	ohikxo numv
WI, CJ	wi cj
PYVHCUSRUZEY, Z	pyvhcusruzey z
Y, G	y g
PORHXUV, V	porhxuv v
ZDTHVKY, LSMM	zdthvky lsmm
Y, PS	y ps
Y, KK	y kk
MJFU, QZ	mjfu qz
B, WN	b wn
DW, ZWH	dw zwh
E, G	e g
D, O	d o
C, Z	c z
TH, HV	th hv
MVR, A	mvr a
ZY, V	zy v
VVUYFNEYVWA, GWICGVCIV	vvuyfneyvwa gwicgvciv
TD, H	td h
M, GO	m go
ADE, X	ade x
BOG, O	bog o
EYX, J	eyx j
RUV, P	ruv p
S, Z	s z
MJCHBZEODIFBZZY, G	mjchbzeodifbzzy g
IJ, QNARL	ij qnarl
H, D	h d
DHFV, CNC	dhfv cnc
VGQ, CUN	vgq cun
VC, VLKZ	vc vlkz
GO, U	go u
O, ACXR	o acxr
Z, TCJ	z tcj
UJ, GVYGHN	uj gvyghn
IXLCQ, X	ixlcq x
RVVQ, UKE	rvvq uke
M, YC	m yc
MBNX, JSLI	mbnx jsli
Q, AKPV	q akpv
OQ, V	oq v
P, LN	p ln
SQ, RB	sq rb
K, XWXAS	k xwxas
VZ, TUYMLA	vz tuymla
SU, ERJ	su erj
PD, WXK	pd wxk
HEALN, T	healn t
X, V	x v
I, Y	i y
W, QM	w qm
Y, EI	y ei
S, B	s b
UA, JY	ua jy
H, S	h s
ZHSO, W	zhso w
WWM, X	wwm x
F, U	f u
OGBU, KC	ogbu kc
K, V	k v
J, ZNU	j znu
I, FAI	i fai
SEK, TAA	sek taa
I, QL	i ql
III, W	iii w
NYK, L	nyk l
TQQ, J	tqq j
G, I	g i
GI, NOEPMS	gi noepms
Q, VJ	q vj
ZI, AHVN	zi ahvn
DR, L	dr l
OGCIOQYO, G	ogcioqyo g
M, Z	m z
J, C	j c
NM, JZHX	nm jzhx
HCEJYZ, U	hcejyz u
YNT, GJJ	ynt gjj
FM, P	fm p
D, S	d s
W, DI	w di
IW, N	iw n
ENH, AOB	enh aob
WDU, F	wdu f
PZ, IMRAVK	pz imravk
CN, JK	cn jk
EZTW, L	eztw l
MRNDPO, Z	mrndpo z
WO, F	wo f
G, K	g k
RHK, K	rhk k
SGM, PS	sgm ps
P, W	p w
XJTOR, P	xjtor p
R, EJG	r ejg
QMI, Y	qmi y
ZOGW, B	zogw b
ZDU, TNB	zdu tnb
M, L	m l
MK, Y	mk y
T, HBRLU	t hbrlu
F, S	f s
YLR, NAJP	ylr najp
LA, B	la b
D, NWY	d nwy
VLSKE, M	vlske m
ZBE, H	zbe h
NZ, X	nz x
M, T	m t
IHN, IJV	ihn ijv
ZZ, DVLSD	zz dvlsd
HWR, F	hwr f
H, W	h w
BMYEIERE, JJUK	bmyeiere jjuk
GT, HVIX	gt hvix
L, G	l g
GNIM, JU	gnim ju
GK, PZ	gk pz
DY, PCZJH	dy pczjh
EF, CM	ef cm
NNITMII, QG	nnitmii qg
D, X	d x
GA, S	ga s
N, CQHLTY	n cqhlty
RB, V	rb v
W, MSF	w msf
AJZ, YR	ajz yr
E, PAXC	e paxc
LQQ, ANLV	lqq anlv
UXDTK, D	uxdtk d
FFGINMZ, YOA	ffginmz yoa
D, QYM	d qym
G, A	g a
NH, P	nh p
L, MM	l mm
F, UVU	f uvu
KKM, P	kkm p
QW, WTPRPFB	qw wtprpfb
DKW, WUV	dkw wuv
S, KXWBT	s kxwbt
SRDUW, VBKH	srduw vbkh
TOTIG, KNA	totig kna
VKPT, A	vkpt a
V, N	v n
ZEYVPBYCONJZ, AT	zeyvpbyconjz at
AN, V	an v
A, RKZB	a rkzb
V, DF	v df
REVSI, J	revsi j
HL, I	hl i
J, OXKMM	j oxkmm
JQUN, YH	jqun yh
BDHK, SE	bdhk se
S, QC	s qc
WLLW, JG	wllw jg
E, X	e x
UR, PCPJN	ur pcpjn
N, HMCXMOLWV	n hmcxmolwv
NQS, G	nqs g
H, PWVWPZXT	h pwvwpzxt
D, F	d f
C, U	c u
P, KCMUYY	p kcmuyy
I, GMLXKV	i gmlxkv
T, KLZ	t klz
XQ, AIA	xq aia
LEA, CV	lea cv
TPNVBT, TM	tpnvbt tm
WYYAQ, QE	wyyaq qe
V, XT	v xt
N, M	n m
PG, F	pg f
TK, BX	tk bx
PW, ZBQPALCE	pw zbqpalce
E, WZAS	e wzas
YNM, XW	ynm xw
ZAB, P	zab p
UUWXMBO, PCEXVN	uuwxmbo pcexvn
ASG, LGQEPC	asg lgqepc
V, OBVPM	v obvpm
UEYTQ, Q	ueytq q
OLZY, FU	olzy fu
K, M	k m
M, Q	m q
QX, OA	qx oa
UHE, S	uhe s
NJ, FBEXZYV	nj fbexzyv
O, WQ	o wq
CQY, I	cqy i
HQP, S	hqp s
EK, C	ek c
N, F	n f
N, CB	n cb
EF, PPX	ef ppx
XEXOWR, E	xexowr e
M, SOAIIT	m soaiit
RW, IR	rw ir
IGVLQ, MHL	igvlq mhl
K, XDP	k xdp
ZECC, QP	zecc qp
QBF, QSK	qbf qsk
D, YH	d yh
ZF, PP	zf pp
OMHN, IU	omhn iu
WFFEGE, UAO	wffege uao
JBOR, WCPFFLK	jbor wcpfflk
E, K	e k
MLQB, PQK	mlqb pqk
UKXZ, WU	ukxz wu
XB, P	xb p
EW, Z	ew z
CD, LGLQSI	cd lglqsi
J, Y	j y
VFR, UJJ	vfr ujj
PW, F	pw f
G, CK	g ck
C, I	c i
R, OE	r oe
WJ, TH	wj th
AZS, PKO	azs pko
LAPOF, KE	lapof ke
MPNV, G	mpnv g
S, C	s c
GRI, H	gri h
V, G	v g
IC, C	ic c
KHGP, E	khgp e
BQURTK, N	bqurtk n
MXBP, FFQUD	mxbp ffqud
RDCC, PNC	rdcc pnc
S, Z	s z
LD, X	ld x
P, R	p r
N, X	n x
D, ILCBOP	d ilcbop
O, MIL	o mil
SHZE, QD	shze qd
SFZ, I	sfz i
QHG, PVXJ	qhg pvxj
AXYZ, GC	axyz gc
W, B	w b
LJ, KP	lj kp
J, HL	j hl
UTMA, Q	utma q
D, GE	d ge
EKJ, FS	ekj fs
IUN, G	iun g
FI, AAC	fi aac
N, NNLI	n nnli
JF, EB	jf eb
ODY, G	ody g
S, FDX	s fdx
GUBG, WJM	gubg wjm
I, HTL	i htl
IE, F	ie f
CBA, ON	cba on
SK, L	sk l
HRBW, GY	hrbw gy
UNU, U	unu u
LI, SR	li sr
D, D	d d
N, L	n l
L, XP	l xp
D, G	d g
SRPM, YOK	srpm yok
RP, ZG	rp zg
JL, Q	jl q
EQPO, Y	eqpo y
V, THH	v thh
NNNGBA, APONXTE	nnngba aponxte
UO, SRC	uo src
JYFR, A	jyfr a
Y, E	y e
NSHSY, GMOU	nshsy gmou
PLR, BN	plr bn
B, TD	b td
Q, K	q k
OVE, Y	ove y
N, X	n x
OMF, B	omf b
WMKUM, ZDQ	wmkum zdq
PDE, IRZBU	pde irzbu
KTMU, YWY	ktmu ywy
TRJKOKLSOO, RW	trjkoklsoo rw
NC, N	nc n
O, NJE	o nje
U, KR	u kr
LB, L	lb l
W, M	w m
QRCY, H	qrcy h
Y, M	y m
Q, JF	q jf
SA, T	sa t
T, SDN	t sdn
O, PY	o py
LUZD, ZX	luzd zx
C, Y	c y
NSJAR, UNRZ	nsjar unrz
Y, KAH	y kah
Z, JF	z jf
A, AYSNR	a aysnr
ZY, N	zy n
G, VD	g vd
R, QK	r qk
YR, FMN	yr fmn
QYC, E	qyc e
Z, JK	z jk
THN, TRCNZRRP	thn trcnzrrp
KNXB, W	knxb w
K, EELG	k eelg
VQC, YN	vqc yn
A, BS	a bs
NZSSS, SDYGGD	nzsss sdyggd
GNEKN, JQJZ	gnekn jqjz
FBVM, HDNTKV	fbvm hdntkv
AEON, P	aeon p
QKIPP, I	qkipp i
Z, H	z h
T, RNAV	t rnav
OX, UR	ox ur
UC, B	uc b
YRC, WOG	yrc wog
MUPC, N	mupc n
RGQ, WO	rgq wo
U, NI	u ni
K, CE	k ce
XO, LIUM	xo lium
G, R	g r
V, J	v j
JOYHHZ, MTI	joyhhz mti
R, L	r l
KM, J	km j
QA, DFRU	qa dfru
TRL, EF	trl ef
VNF, GQB	vnf gqb
Z, Q	z q
R, BFO	r bfo
HLZ, U	hlz u
H, R	h r
MRVWIT, WA	mrvwit wa
L, T	l t
CQC, AWNY	cqc awny
O, GCJY	o gcjy
P, WZ	p wz
TP, O	tp o
JHK, J	jhk j
UGSZR, IMJC	ugszr imjc
RS, Y	rs y
AYYUB, YINU	ayyub yinu
XLML, L	xlml l
PFT, P	pft p
D, QS	d qs
TDFG, GX	tdfg gx
U, FV	u fv
DV, O	dv o
B, YNVWOW	b ynvwow
K, U	k u
YWO, Z	ywo z
FH, BF	fh bf
ETWK, Q	etwk q
B, RN	b rn
E, AE	e ae
S, DOK	s dok
D, U	d u
FGKA, IO	fgka io
H, EDQ	h edq
Z, AR	z ar
SXEC, E	sxec e
TR, B	tr b
A, SQ	a sq
H, B	h b
XT, M	xt m
UK, VT	uk vt
TZH, Q	tzh q
OLTO, S	olto s
T, W	t w
J, ZMQX	j zmqx
AN, I	an i
SLSAU, OZ	slsau oz
H, V	h v
UY, KIKVBMG	uy kikvbmg
Q, RYGK	q rygk
J, UZCN	j uzcn
WCAHD, RZI	wcahd rzi
H, FP	h fp
BKP, Y	bkp y
XT, V	xt v
T, N	t n
BGD, U	bgd u
EC, UBKS	ec ubks
Z, FUIS	z fuis
V, R	v r
AZE, FSFFF	aze fsfff
YLWHC, X	ylwhc x
SK, HE	sk he
L, NTP	l ntp
A, IP	a ip
M, F	m f
UYE, T	uye t
GMYH, IDYT	gmyh idyt
LJDGX, VTJO	ljdgx vtjo
BJG, YR	bjg yr
VPKYZU, F	vpkyzu f
S, GN	s gn
TB, TJWRSNJ	tb tjwrsnj
D, CSO	d cso
G, U	g u
MXTMP, T	mxtmp t
KSISHZ, FG	ksishz fg
NI, GY	ni gy
CZ, Q	cz q
CWD, T	cwd t
NJ, O	nj o
BSVTBB, I	bsvtbb i
H, ZQDHH	h zqdhh
NQGWLRVF, MFCBUSQYJ	nqgwlrvf mfcbusqyj
Z, J	z j
EAMVL, JXXKW	eamvl jxxkw
GFP, Q	gfp q
CV, I	cv i
I, YI	i yi
V, BDWDBMUT	v bdwdbmut
V, X	v x
MJFLRHW, K	mjflrhw k
D, HJ	d hj
SGD, JHTLE	sgd jhtle
QE, K	qe k
O, I	o i
BHYG, V	bhyg v
RINIHAMUK, X	rinihamuk x
D, DA	d da
I, I	i i
U, ACE	u ace
TM, F	tm f
MJ, ZNOPWF	mj znopwf
ZA, JCZ	za jcz
EIV, VSAIMV	eiv vsaimv
RHH, KN	rhh kn
C, SM	c sm
FJKHY, UZKGIWTWD	fjkhy uzkgiwtwd
VV, NZIJ	vv nzij
T, YF	t yf
G, V	g v
JYKU, OT	jyku ot
HCJJWDD, APQ	hcjjwdd apq
M, WCZW	m wczw
I, BT	i bt
ADKZKBLB, OJ	adkzkblb oj
C, EBL	c ebl
P, G	p g
D, TF	d tf
PK, NL	pk nl
X, YNODGW	x ynodgw
X, YI	x yi
GKGA, QGDM	gkga qgdm
XM, LRUTIP	xm lrutip
BNMVW, PF	bnmvw pf
N, S	n s
ELOA, O	eloa o
ZXQ, GRBRBMW	zxq grbrbmw
F, UC	f uc
F, M	f m
HGM, H	hgm h
SMG, R	smg r
UHZREF, ZM	uhzref zm
JO, GQ	jo gq
VUPZY, QDXT	vupzy qdxt
E, YFKG	e yfkg
MBTABXW, ESWGJQSRF	mbtabxw eswgjqsrf
QU, Z	qu z
CO, HN	co hn
UFNA, LFSC	ufna lfsc
TV, RSWT	tv rswt
S, Z	s z
QXJE, Q	qxje q
J, TV	j tv
K, S	k s
N, P	n p
A, A	a a
G, GWSNQ	g gwsnq
UHXYXA, BDN	uhxyxa bdn
E, U	e u
SH, Y	sh y
Y, IL	y il
IIMJI, OGGFYT	iimji oggfyt
PYBCHWXNTHR, P	pybchwxnthr p
QYAM, X	qyam x
PKEM, B	pkem b
LRIS, NS	lris ns
R, STW	r stw
J, F	j f
H, L	h l
PX, WCLKKA	px wclkka
S, CCMO	s ccmo
H, NQQMWWXM	h nqqmwwxm
PI, JDZ	pi jdz
WS, OP	ws op
D, K	d k
H, RQCX	h rqcx
P, UECRU	p uecru
K, FN	k fn
PYSLPX, HU	pyslpx hu
BQEXLJERN, AEFGJGRV	bqexljern aefgjgrv
ENV, W	env w
XIS, SJOMZNL	xis sjomznl
V, TK	v tk
AA, D	aa d
QOHJWJ, GBJ	qohjwj gbj
U, A	u a
B, SCFH	b scfh
AGV, PCJ	agv pcj
ICJ, RSG	icj rsg
PIQXI, OHF	piqxi ohf
VSDB, NG	vsdb ng
M, E	m e
P, B	p b
QA, M	qa m
G, I	g i
QEXC, U	qexc u
W, SXX	w sxx
A, D	a d
VJ, D	vj d
T, TDGJZNHCUDSXNVIMH	t tdgjznhcudsxnvimh
HX, DQRQB	hx dqrqb
DK, BZ	dk bz
R, ZU	r zu
JQ, M	jq m
HW, R	hw r
LJL, VFJC	ljl vfjc
D, W	d w
X, TKRTT	x tkrtt
UK, BJXIB	uk bjxib
HDI, WL	hdi wl
A, RSBH	a rsbh
A, XNQX	a xnqx
MMAI, B	mmai b
VFU, O	vfu o
AQC, N	aqc n
O, SUQ	o suq
Q, X	q x
F, YU	f yu
R, M	r m
A, E	a e
C, RWD	c rwd
J, F	j f
D, LA	d la
HDH, XD	hdh xd
TG, V	tg v
OJYIRSYF, C	ojyirsyf c
P, ZVW	p zvw
SE, C	se c
V, ZE	v ze
OB, KVVJPROQA	ob kvvjproqa
LBYMW, AZIDRU	lbymw azidru
MDJP, U	mdjp u
LVRBZZPN, G	lvrbzzpn g
UBX, IGP	ubx igp
KU, M	ku m
Q, XY	q xy
Y, PS	y ps
RBHM, MU	rbhm mu
I, T	i t
J, IC	j ic
FVGVJT, P	fvgvjt p
O, Z	o z
O, ARD	o ard
VHV, K	vhv k
Q, XV	q xv
IA, R	ia r
C, YGJA	c ygja
U, OOP	u oop
OE, ALRAGQN	oe alragqn
B, B	b b
I, V	i v
URWZV, MG	urwzv mg
MS, E	ms e
NR, O	nr o
XXW, LV	xxw lv
P, AWQGL	p awqgl
H, VJC	h vjc
MPSMTPPAL, WI	mpsmtppal wi
EEHV, BPCAD	eehv bpcad
PITM, J	pitm j
AYX, WDI	ayx wdi
FPW, N	fpw n
IW, RLPVFYNUU	iw rlpvfynuu
C, F	c f
BHK, E	bhk e
W, QZ	w qz
WWCOWHWV, DL	wwcowhwv dl
URE, VW	ure vw
N, DG	n dg
TMVRTXM, MVLB	tmvrtxm mvlb
BOF, MAQM	bof maqm
CP, V	cp v
M, CS	m cs
ZGQQ, G	zgqq g
P, EQ	p eq
E, X	e x
WKD, AH	wkd ah
I, CA	i ca
L, H	l h
G, Y	g y
K, IR	k ir
G, Y	g y
W, U	w u
X, TC	x tc
RBX, O	rbx o
X, JVXUMQ	x jvxumq
E, W	e w
O, K	o k
UB, D	ub d
B, BH	b bh
NQ, W	nq w
WD, RVSE	wd rvse
HFWBSDCKD, KYNY	hfwbsdckd kyny
K, YAVL	k yavl
QVU, YC	qvu yc
AU, LQ	au lq
A, OWKSB	a owksb
J, DF	j df
A, O	a o
FV, EID	fv eid
D, I	d i
O, L	o l
I, H	i h
G, QLKU	g qlku
C, EWNQ	c ewnq
H, OLFS	h olfs
AVVW, FH	avvw fh
B, Q	b q
Y, S	y s
B, D	b d
FAEZADRFMUGKO, QD	faezadrfmugko qd
IY, R	iy r
NTXY, FZ	ntxy fz
SR, R	sr r
FBB, FHZPOAZDD	fbb fhzpoazdd
F, JA	f ja
BDY, BPEA	bdy bpea
MA, N	ma n
Z, A	z a
CEYPLV, JU	ceyplv ju
LE, PHT	le pht
VK, X	vk x
BNV, C	bnv c
IBXT, RKOU	ibxt rkou
VF, H	vf h
SLSORBQ, P	slsorbq p
XXD, Q	xxd q
H, XP	h xp
O, K	o k
WGY, K	wgy k
P, LKG	p lkg
RPGTB, J	rpgtb j
R, VZA	r vza
IVZC, Q	ivzc q
UDB, U	udb u
F, F	f f
AAX, OHZ	aax ohz
QB, QMCS	qb qmcs
Y, M	y m
KXODR, ZTD	kxodr ztd
H, OIWG	h oiwg
RG, BJD	rg bjd
Z, SX	z sx
X, J	x j
OBU, M	obu m
FM, P	fm p
AR, D	ar d
I, V	i v
Y, YJ	y yj
DTP, J	dtp j
R, JQ	r jq
P, P	p p
VNJ, E	vnj e
X, H	x h
B, PXHUHLENG	b pxhuhleng
F, N	f n
ST, N	st n
N, WWPT	n wwpt
M, E	m e
VNDE, N	vnde n
DUKM, J	dukm j
O, W	o w
V, UINEVL	v uinevl
B, P	b p
C, BRGK	c brgk
W, EGZ	w egz
S, YN	s yn
GC, X	gc x
G, G	g g
I, W	i w
ZD, EEP	zd eep
E, W	e w
L, I	l i
DG, NLZLM	dg nlzlm
AZA, KF	aza kf
G, KX	g kx
RNG, FKPK	rng fkpk
S, AGW	s agw
GG, S	gg s
W, MQE	w mqe
CK, Y	ck y
UV, FP	uv fp
F, KLY	f kly
E, SD	e sd
W, I	w i
G, T	g t
YCK, NJE	yck nje
CDPT, VL	cdpt vl
AMVA, K	amva k
B, FTZAGG	b ftzagg
DF, ALBF	df albf
GI, XTU	gi xtu
V, Z	v z
EN, S	en s
D, NTHFT	d nthft
IQN, FK	iqn fk
AOQS, DL	aoqs dl
OACJ, H	oacj h
DTB, SOQ	dtb soq
JXGZDEL, TUT	jxgzdel tut
CEQ, JC	ceq jc
F, K	f k
D, J	d j
SV, NKKJ	sv nkkj
DRWP, XHFPJ	drwp xhfpj
Q, DX	q dx
TF, HTIK	tf htik
D, VX	d vx
O, JUVDJ	o juvdj
PVVSXDC, E	pvvsxdc e
T, YS	t ys
O, SV	o sv
TTRRM, I	ttrrm i
RISK, YT	risk yt
TUSSMT, G	tussmt g
G, S	g s
QKRR, ATE	qkrr ate
AH, X	ah x
R, O	r o
HR, EQ	hr eq
X, Z	x z
HUBQ, JWRITOBPXK	hubq jwritobpxk
TD, JTZ	td jtz
MR, O	mr o
HH, LOAP	hh loap
X, Q	x q
B, MH	b mh
FAOVF, YA	faovf ya
NK, MYE	nk mye
I, FSU	i fsu
V, RKBQU	v rkbqu
PDCC, II	pdcc ii
H, LHTIRN	h lhtirn
THJT, HG	thjt hg
Z, K	z k
VW, SD	vw sd
QU, HCBSHF	qu hcbshf
UPZR, PSD	upzr psd
MGEVOW, D	mgevow d
OAZB, NBU	oazb nbu
U, G	u g
YOBTFJIMH, CA	yobtfjimh ca
OPHFLM, SW	ophflm sw
UENE, B	uene b
Q, CPJ	q cpj
OUL, B	oul b