OHGQ, VWS	ohgq vws
V, RH	v rh
XJ, PHXT	xj phxt
U, A	u a
RUNDA, JI	runda ji
S, F	s f
XS, ZX	xs zx
X, Z	x z
JEHRGMEV, T	jehrgmev t
A, F	a f
HH, XF	hh xf
SZ, ISJ	sz isj
I, JPZ	i jpz
KJZW, OICL	kjzw oicl
P, F	p f
W, BWBB	w bwbb
SCI, ADFE	sci adfe
L, CLY	l cly
AKES, SV	akes sv
IYRYF, B	iyryf b
YRJB, CF	yrjb cf
ON, X	on x
BME, L	bme l
AP, WA	ap wa
R, PNUW	r pnuw
O, ABORP	o aborp
EF, UVZ	ef uvz
UQEQZWZZ, E	uqeqzwzz e
ZZAVHDZ, UY	zzavhdz uy
K, J	k j
N, PY	n py
QQHMOZISB, OTH	qqhmozisb oth
IGH, E	igh e
KC, JD	kc jd
L, TGA	l tga
AXXWQ, MB	axxwq mb
XOFOW, T	xofow t
P, TW	p tw
Q, H	q h
DR, ABOGUSNG	dr abogusng
T, I	t i
QXIS, MHN	qxis mhn
EH, EP	eh ep
KTW, VZISD	ktw vzisd
SF, H	sf h
PU, QYR	pu qyr
Y, SN	y sn
T, YHFLM	t yhflm
WE, GVIUG	we gviug
P, UPW	p upw
BZ, RN	bz rn
XX, R	xx r
HINHI, P	hinhi p
PA, K	pa k
PZYBW, B	pzybw b
Q, U	q u
BE, DD	be dd
K, F	k f
JDX, UQGXAY	jdx uqgxay
QFCSC, LEFZ	qfcsc lefz
MAR, MO	mar mo
VZSS, PFNTXPOVV	vzss pfntxpovv
YAT, Y	yat y
PBIUCBAS, MX	pbiucbas mx
PT, D	pt d
X, S	x s
B, ZH	b zh
X, T	x t
ERAS, IW	eras iw
PJ, O	pj o
M, Y	m y
XZ, E	xz e
S, V	s v
NT, MPG	nt mpg
P, EDH	p edh
C, T	c t
A, SRTDWQNA	a srtdwqna
Y, N	y n
CHKP, JOXNT	chkp joxnt
BF, EM	bf em
M, WT	m wt
T, LCK	t lck
ZJB, BAWTTG	zjb bawttg
ZZE, UF	zze uf
Y, REXW	y rexw
Q, F	q f
N, XI	n xi
X, AKF	x akf
F, UV	f uv
Q, PNRQSQ	q pnrqsq
D, OT	d ot
LIC, WYNZ	lic wynz
AUV, P	auv p
ZMFV, XUCPF	zmfv xucpf
JXPAV, R	jxpav r
URG, E	urg e
XDE, GD	xde gd
MGD, DGX	mgd dgx
Z, U	z u
FVM, JXR	fvm jxr
N, LCSB	n lcsb
BH, L	bh l
B, GN	b gn
EUI, G	eui g
GDL, NHDYXHCK	gdl nhdyxhck
QW, UUDG	qw uudg
XA, G	xa g
FRHNCYAATX, O	frhncyaatx o
PBRBBI, G	pbrbbi g
MD, UCX	md ucx
F, GXYGVT	f gxygvt
D, EKUYV	d ekuyv
K, I	k i
K, W	k w
H, W	h w
KHBZR, U	khbzr u
CRD, T	crd t
ME, OFEJQJM	me ofejqjm
R, B	r b
XQ, B	xq b
O, YAIXZEMIJ	o yaixzemij
YH, H	yh h
GLS, U	gls u
I, GY	i gy
F, KV	f kv
I, Y	i y
MLO, X	mlo x
M, OCB	m ocb
Q, DV	q dv
EWVBM, O	ewvbm o
M, B	m b
EPZ, VHE	epz vhe
YN, WAF	yn waf
TOLV, VH	tolv vh
PA, UKHE	pa ukhe
T, P	t p
R, Z	r z
I, VUBP	i vubp
G, F	g f
VLITMNN, MDBFG	vlitmnn mdbfg
G, FYHZ	g fyhz
WNJAADQ, MWSS	wnjaadq mwss
IPJXCGCGJ, HWA	ipjxcgcgj hwa
NV, J	nv j
N, MIG	n mig
M, FL	m fl
MJ, E	mj e
QGD, UKL	qgd ukl
T, X	t x
S, N	s n
VY, LRZXSEQU	vy lrzxsequ
S, H	s h
C, XBNVS	c xbnvs
PHR, M	phr m
F, VC	f vc
WM, W	wm w
E, TRVL	e trvl
MMR, YII	mmr yii
FYEAAGFCTZNKDY, NFJE	fyeaagfctznkdy nfje
WHTB, VI	whtb vi
G, BAZGH	g bazgh
GNB, NB	gnb nb
D, GXA	d gxa
JD, TQ	jd tq
I, GNW	i gnw
GN, A	gn a
Q, NQX	q nqx
B, KIQ	b kiq
ROP, TBX	rop tbx
HMTJX, XOVF	hmtjx xovf
PB, ZHIC	pb zhic
XZXEPS, MFKE	xzxeps mfke
AL, RO	al ro
V, LJQTEDOUKZHQ	v ljqtedoukzhq
HZHO, RHNKDF	hzho rhnkdf
YE, Y	ye y
WP, CFY	wp cfy
ZJ, IB	zj ib
TQUNO, XZJBDPXYA	tquno xzjbdpxya
A, QS	a qs
FW, GD	fw gd
PL, PN	pl pn
JU, CAY	ju cay
C, ELT	c elt
JBCQLMB, KT	jbcqlmb kt
YCXFNJXY, KP	ycxfnjxy kp
G, QM	g qm
VS, WV	vs wv
WIY, R	wiy r
GORH, T	gorh t
A, SG	a sg
JZBVZC, O	jzbvzc o
NCN, Z	ncn z
ELWN, VY	elwn vy
B, JSY	b jsy
XI, ZJ	xi zj
KOKSKS, P	koksks p
AYE, P	aye p
QGNXA, TIMY	qgnxa timy
W, PA	w pa
KGFS, T	kgfs t
IABO, UL	iabo ul
TCR, WR	tcr wr
B, NOSA	b nosa
W, KFBP	w kfbp
ED, C	ed c
JO, LRLUAJCDK	jo lrluajcdk
W, GWSWVQ	w gwswvq
CH, RJ	ch rj
RB, FF	rb ff
YEX, I	yex i
Y, BBNBAONZ	y bbnbaonz
RSUHBSK, ZH	rsuhbsk zh
U, D	u d
L, E	l e
N, AT	n at
T, ZHTIV	t zhtiv
IFXL, HT	ifxl ht
ZZ, BOPA	zz bopa
KDVWICAY, Z	kdvwicay z
ZUO, X	zuo x
H, UMVY	h umvy
HG, UQZ	hg uqz
P, B	p b
GBCUP, K	gbcup k
AS, ICJU	as icju
JP, R	jp r
DSI, OD	dsi od
EDSSCSYFET, X	edsscsyfet x
Y, T	y t
G, NDM	g ndm
OZBGNIA, SP	ozbgnia sp
VV, D	vv d
S, PPPWJB	s pppwjb
P, I	p i
NPQOD, X	npqod x
MS, OL	ms ol
V, T	v t
I, QCE	i qce
SI, YDM	si ydm
Y, K	y k
OLHB, YQOX	olhb yqox
DJN, R	djn r
FEYWS, N	feyws n
KXZ, IH	kxz ih
E, ZD	e zd
HQKTL, UURL	hqktl uurl
R, Y	r y
YOTFQ, CQV	yotfq cqv
X, YG	x yg
PY, D	py d
DOOQL, H	dooql h
PIYWJ, PKR	piywj pkr
OBF, MPTFQ	obf mptfq
RX, E	rx e
Y, XWY	y xwy
K, ZFL	k zfl
PBT, JD	pbt jd
F, K	f k
A, SW	a sw
G, GRN	g grn
EE, QRQB	ee qrqb
BMDZP, G	bmdzp g
MZLXY, TX	mzlxy tx
QPT, S	qpt s
D, TVX	d tvx
MLK, CKK	mlk ckk
RK, M	rk m
BNA, KOMJ	bna komj
A, X	a x
F, L	f l
ZH, QX	zh qx
L, JRDNFZRU	l jrdnfzru
O, PHO	o pho
V, PI	v pi
E, H	e h
TBM, G	tbm g
ZFK, N	zfk n
GOQDJ, RNULE	goqdj rnule
Z, S	z s
E, YA	e ya
R, OBIPOZ	r obipoz
E, V	e v
Q, A	q a
P, YZL	p yzl
VYMYCM, VY	vymycm vy
FVZHZ, JH	fvzhz jh
VA, PQ	va pq
TR, FR	tr fr
KWSQL, G	kwsql g
UM, EEOMZR	um eeomzr
B, WQABJBU	b wqabjbu
FGLT, EXEDS	fglt exeds
H, V	h v
UFUR, YNWN	ufur ynwn
V, NC	v nc
XOB, W	xob w
W, G	w g
O, W	o w
W, PRU	w pru
HZ, I	hz i
UWW, M	uww m
RJDP, XDCJ	rjdp xdcj
EOL, YUPL	eol yupl
AC, Q	ac q
JQT, O	jqt o
G, D	g d
X, B	x b
XSADJM, T	xsadjm t
L, MNX	l mnx
NF, A	nf a
KSUG, W	ksug w
S, UFDF	s ufdf
LJ, RA	lj ra
FY, IKH	fy ikh
O, MU	o mu
VX, DG	vx dg
LE, ZB	le zb
Y, I	y i
E, J	e j
QUWQ, ZLG	quwq zlg
K, PC	k pc
R, B	r b
PBNUC, OL	pbnuc ol
FC, V	fc v
YXNDJDHBJDVFRNC, D	yxndjdhbjdvfrnc d
ET, KU	et ku
J, K	j k
R, TLT	r tlt
H, IQE	h iqe
EE, ZJ	ee zj
P, GYEE	p gyee
TAJRW, GSKP	tajrw gskp
BY, GTZ	by gtz
EXC, A	exc a
D, IH	d ih
M, B	m b
MOPOZE, R	mopoze r
IKFPA, ZJHY	ikfpa zjhy
DXTPHEJUEW, K	dxtphejuew k
KM, UH	km uh
I, U	i u
F, GRGBU	f grgbu
D, V	d v
HBB, KB	hbb kb
Z, Y	z y
PO, AZ	po az
CJIYWLO, ATD	cjiywlo atd
R, H	r h
A, E	a e
JH, Q	jh q
BI, NP	bi np
X, O	x o
BW, N	bw n
B, FO	b fo
G, U	g u
Y, M	y m
GX, RX	gx rx
D, CR	d cr
SLARL, FZMBADUKY	slarl fzmbaduky
W, CYL	w cyl
F, R	f r
SQL, Z	sql z
ECN, WW	ecn ww
LAPW, AOF	lapw aof
N, USD	n usd
S, T	s t
B, J	b j
FBB, TWB	fbb twb
F, HY	f hy
JBNIDVJN, R	jbnidvjn r
B, ZJO	b zjo
W, J	w j
M, J	m j
M, DRNSU	m drnsu
E, OJZII	e ojzii
X, XMBEERY	x xmbeery
MOWZN, I	mowzn i
AVAWR, PO	avawr po
OG, L	og l
ASG, CNIWCYU	asg cniwcyu
IG, P	ig p
SSU, R	ssu r
WCIJ, A	wcij a
FCWM, MU	fcwm mu
F, JGVTVW	f jgvtvw
S, DJE	s dje
BE, GN	be gn
R, E	r e
XP, KL	xp kl
IRLCVYE, WNQ	irlcvye wnq
ZKS, S	zks s
IHPB, LU	ihpb lu
I, SQG	i sqg
VQ, X	vq x
U, UYBF	u uybf
HN, QS	hn qs
S, DZ	s dz
HXMB, KP	hxmb kp
NM, H	nm h
NV, DN	nv dn
J, T	j t
Z, LY	z ly
KFKOEB, B	kfkoeb b
YA, HO	ya ho
EJA, S	eja s
GSC, WC	gsc wc
ABL, G	abl g
OLQ, V	olq v
B, QKJA	b qkja
UNEEFRSAGW, M	uneefrsagw m
TNSYF, SL	tnsyf sl
DRUR, HP	drur hp
G, H	g h
C, A	c a
NN, F	nn f
OM, CT	om ct
SG, A	sg a
CEAN, UTG	cean utg
A, O	a o
Z, DDTO	z ddto
U, UU	u uu
PZT, Y	pzt y
D, E	d e
BV, VU	bv vu
BQHJ, KSVT	bqhj ksvt
RSDV, RZU	rsdv rzu
U, V	u v
SHIOMFDW, EI	shiomfdw ei
Z, RD	z rd
EX, U	ex u
P, C	p c
B, U	b u
MZBVX, U	mzbvx u
M, IURP	m iurp
Y, F	y f
L, HVQ	l hvq
Q, R	q r
L, MTIJKM	l mtijkm
Z, DPJZV	z dpjzv
G, WOD	g wod
MTR, TCV	mtr tcv
YQM, W	yqm w
VHYBU, U	vhybu u
APM, JFQJ	apm jfqj
E, M	e m
CT, F	ct f
SLWDO, NVXYG	slwdo nvxyg
Z, CPXL	z cpxl
ZA, YY	za yy
KR, MN	kr mn
HFI, JUGE	hfi juge
GR, Q	gr q
LRP, E	lrp e
VMZZW, SFZRN	vmzzw sfzrn
TYQ, P	tyq p
CXK, SDIB	cxk sdib
QW, GGI	qw ggi
S, LMEXXBFNV	s lmexxbfnv
E, N	e n
FLH, W	flh w
WJZ, UE	wjz ue
QF, T	qf t
YCLQ, DF	yclq df
YS, KBMJRY	ys kbmjry
COC, P	coc p
W, W	w w
ZJIBXS, Z	zjibxs z
N, UBTKAL	n ubtkal
O, MX	o mx
K, CITY	k city
S, VRA	s vra
VKKGJV, XI	vkkgjv xi
JROCE, Z	jroce z
LL, TAPY	ll tapy
PJX, R	pjx r
I, M	i m
H, JV	h jv
N, OCLS	n ocls
J, AG	j ag
J, G	j g
INA, M	ina m
JA, W	ja w
L, VWIGTXP	l vwigtxp
U, NDTLZZNEYF	u ndtlzzneyf
SV, R	sv r
K, G	k g
A, UETH	a ueth
YDV, TA	ydv ta
TZ, MN	tz mn
IE, S	ie s
MZ, L	mz l
P, AI	p ai
H, H	h h
JIQ, K	jiq k
HLWXBZM, MV	hlwxbzm mv
XW, O	xw o
QN, XF	qn xf
TFH, K	tfh k
H, J	h j
TKQC, JW	tkqc jw
XWNWD, UE	xwnwd ue
S, HFI	s hfi
CF, J	cf j
RV, X	rv x
A, PO	a po
WKZF, J	wkzf j
EPZE, JC	epze jc
Y, ECYQJ	y ecyqj
JTA, KGF	jta kgf
Q, QIZ	q qiz
UTN, EN	utn en
TFXX, SWMZM	tfxx swmzm
VN, L	vn l
N, HIC	n hic
KKUD, AHQCW	kkud ahqcw
NW, G	nw g
WG, ER	wg er
AX, SPW	ax spw
YV, CG	yv cg
VUW, F	vuw f
MQPD, BYGLFGQT	mqpd byglfgqt
HV, NJZAAD	hv njzaad
DMPR, VMX	dmpr vmx
YWGI, Z	ywgi z
CZX, INIW	czx iniw
UCN, I	ucn i
HVTHG, NMP	hvthg nmp
Y, UM	y um
LS, DCQXI	ls dcqxi
ZE, JHISRYS	ze jhisrys
T, OMZJG	t omzjg
F, Y	f y
R, G	r g
WRN, N	wrn n
DNHUJ, BFK	dnhuj bfk
QSO, Z	qso z
JYSF, K	jysf k
MUV, W	muv w
IAHA, SL	iaha sl
M, X	m x
K, LH	k lh
P, R	p r
YBJ, H	ybj h
DKDB, DSXU	dkdb dsxu
OOVRM, N	oovrm n
RGDHFVG, HMS	rgdhfvg hms
I, KCQJXN	i kcqjxn
L, HMZDF	l hmzdf
N, TZUA	n tzua
WVTEH, K	wvteh k
MRMO, D	mrmo d
FE, EB	fe eb
O, OMX	o omx
Y, DTLK	y dtlk
G, K	g k
Z, JX	z jx
VR, YKBO	vr ykbo
TJRV, T	tjrv t
NHLVJD, UN	nhlvjd un
JXLSZ, B	jxlsz b
X, T	x t
OOZDC, ZOXT	oozdc zoxt
PL, OWB	pl owb
S, I	s i
O, QFF	o qff
PG, A	pg a
I, D	i d
W, F	w f
DK, EXIXLT	dk exixlt
VKG, ZF	vkg zf
OPWNZXY, G	opwnzxy g
M, L	m l
B, OA	b oa
K, WL	k wl
YEXS, C	yexs c
T, QWBOC	t qwboc
CTZM, TJA	ctzm tja
IUJH, BGXVQUBHQEG	iujh bgxvqubhqeg
P, E	p e
M, Y	m y
L, H	l h
PWS, HS	pws hs
B, WJSXHBPY	b wjsxhbpy
KIWCSD, S	kiwcsd s
R, XUDJDTL	r xudjdtl
DZ, EJWNT	dz ejwnt
Q, VPLTRC	q vpltrc
FD, O	fd o
F, R	f r
TS, Q	ts q
DLW, KAY	dlw kay
CGW, PRVARI	cgw prvari
B, QEV	b qev
F, JYLOR	f jylor
W, JXBR	w jxbr
R, K	r k
KPGTTVXZ, HCVCO	kpgttvxz hcvco
F, MT	f mt
VHQSY, W	vhqsy w
K, GM	k gm
IIQ, GP	iiq gp
XWCK, I	xwck i
ZBUT, S	zbut s
Q, WGFNIRW	q wgfnirw
B, KLLHOYQUP	b kllhoyqup
UEWFPI, JBNMK	uewfpi jbnmk
BRCHQ, FQ	brchq fq
OQ, FX	oq fx
P, G	p g
A, QHYZ	a qhyz
OD, MMCOR	od mmcor
LLP, FZ	llp fz
CEWZ, RY	cewz ry
AFS, BN	afs bn
RP, RW	rp rw
KAS, O	kas o
HD, J	hd j
ELOJW, X	elojw x
BU, CBA	bu cba
JR, C	jr c
O, OW	o ow
V, YY	v yy
NC, S	nc s
V, X	v x
U, WH	u wh
PFB, YSDM	pfb ysdm
VW, T	vw t
G, WWQ	g wwq
PKE, NRY	pke nry
D, SKN	d skn
X, P	x p
L, BBRX	l bbrx
AEF, QG	aef qg
ZDXELGW, F	zdxelgw f
S, JNN	s jnn
K, A	k a
O, LBTRP	o lbtrp
KHFB, Z	khfb z
TB, TBII	tb tbii
N, R	n r
Z, X	z x
F, SVHW	f svhw
L, P	l p
W, CTX	w ctx
MR, IGE	mr ige
SYZG, Z	syzg z
M, N	m n
U, XL	u xl
JL, O	jl o
XU, T	xu t
L, G	l g
X, M	x m
J, TYPB	j typb
Z, RA	z ra
Z, B	z b
ZE, X	ze x
KP, QL	kp ql
PAX, N	pax n
ZD, R	zd r
UZGED, JBRW	uzged jbrw
QJ, G	qj g
G, ZXHJKOX	g zxhjkox
W, O	w o
JJEH, NPA	jjeh npa
N, EMZA	n emza
Q, B	q b
B, N	b n
H, BA	h ba
OSM, GC	osm gc
KN, YOY	kn yoy
HGTPL, SJ	hgtpl sj
OORC, O	oorc o
UOHO, AMV	uoho amv
J, B	j b
FR, K	fr k
EWXD, LGDN	ewxd lgdn
VU, ZBPN	vu zbpn
EZOMN, Z	ezomn z
DT, ZJJEFGGOJZHMPGR	dt zjjefggojzhmpgr
FY, DKHHUR	fy dkhhur
C, A	c a
LM, E	lm e
WWBU, NZLYAWKAP	wwbu nzlyawkap
YRQ, MC	yrq mc
P, PY	p py
NCVDH, AT	ncvdh at
QBMIQ, VD	qbmiq vd
P, V	p v
OX, IQBLMED	ox iqblmed
X, PGXHVO	x pgxhvo
OMDN, FF	omdn ff
U, KS	u ks
UCCC, VGC	uccc vgc
Q, NX	q nx
KAG, V	kag v
XRF, RMW	xrf rmw
XYLU, D	xylu d
DV, PKMQIZHYCPY	dv pkmqizhycpy
UNGWH, JD	ungwh jd
J, DWJ	j dwj
LL, FQMKTQ	ll fqmktq
LV, UQ	lv uq
WCPM, HYS	wcpm hys
OA, HTS	oa hts
J, HFM	j hfm
OY, WUSW	oy wusw
SBATN, RS	sbatn rs
WKS, K	wks k
K, S	k s
BO, JX	bo jx
WFIV, M	wfiv m
YA, CQ	ya cq
P, NB	p nb
G, OYWNW	g oywnw
ENU, IYE	enu iye
YIE, IMB	yie imb
ZQ, I	zq i
LH, RF	lh rf
T, D	t d
PN, PASVUP	pn pasvup
BNLFA, T	bnlfa t
DA, YX	da yx
S, XE	s xe
CAMMSY, N	cammsy n
GGYLS, TUXD	ggyls tuxd
J, XBHXO	j xbhxo
W, AFU	w afu
AW, AH	aw ah
X, Z	x z
YZ, QBC	yz qbc
U, P	u p
DFE, KD	dfe kd
N, W	n w
EACMRB, VBYH	eacmrb vbyh
IIQ, RA	iiq ra
IHJWW, L	ihjww l
FU, V	fu v
QVTW, L	qvtw l
LQ, K	lq k
M, PVQ	m pvq
NJBTGI, R	njbtgi r
P, CQI	p cqi
MMLYJES, T	mmlyjes t
B, IB	b ib
NS, MZ	ns mz
EDWGJJKVA, M	edwgjjkva m
S, LHL	s lhl
C, EMK	c emk
J, D	j d
C, J	c j
PA, QGTRP	pa qgtrp
C, BIF	c bif
I, F	i f
K, XFIV	k xfiv
YSZV, E	yszv e
XE, XP	xe xp
LG, A	lg a
B, NZYE	b nzye
G, CWIFBY	g cwifby
SU, YXO	su yxo
L, N	l n
KL, V	kl v
T, ND	t nd
HJV, NN	hjv nn
ZIR, E	zir e
E, SSFJ	e ssfj
IRE, RKX	ire rkx
BBRG, L	bbrg l
CIR, V	cir v
NUFS, J	nufs j
R, X	r x
JBA, MB	jba mb
B, KG	b kg
EWCX, EJY	ewcx ejy
Q, I	q i
U, YJEP	u yjep
F, W	f w
O, E	o e
UTNY, NR	utny nr
PEGS, FHUMDHDE	pegs fhumdhde
K, HGS	k hgs
EG, GUN	eg gun
C, JQ	c jq
HI, KPS	hi kps
I, UKLRCSS	i uklrcss
J, LGKO	j lgko
CNE, PC	cne pc
SV, RM	sv rm
Q, IKS	q iks
QD, E	qd e
WDH, V	wdh v
DM, T	dm t
Q, I	q i
AQV, DHI	aqv dhi
BA, KGN	ba kgn
KIS, NGCTIKU	kis ngctiku
P, F	p f
L, APZ	l apz
IJSM, VF	ijsm vf
IY, F	iy f
VPQRMURTR, HW	vpqrmurtr hw
YPEHVX, H	ypehvx h
SVG, Y	svg y
GD, NE	gd ne
MCT, TG	mct tg
N, YT	n yt
B, OBC	b obc
IQ, OV	iq ov
VEBD, B	vebd b
SJJH, GGJY	sjjh ggjy
MIXBPFGU, FFK	mixbpfgu ffk
A, L	a l
CMBPR, H	cmbpr h
X, MON	x mon
OICDB, OJFXULAU	oicdb ojfxulau
D, FMF	d fmf
LXY, AEPJAF	lxy aepjaf
TNZ, PAHMCJEWG	tnz pahmcjewg
NE, S	ne s
KV, M	kv m
DSUYEMRNNQ, K	dsuyemrnnq k
N, A	n a
T, DU	t du
U, KTM	u ktm
ZAADOPWKPOSZ, NT	zaadopwkposz nt
FIBN, ZJPG	fibn zjpg
DX, KZZZMTI	dx kzzzmti
AK, X	ak x
H, SVPCM	h svpcm
X, S	x s
BN, KO	bn ko
WQME, VP	wqme vp
NL, KZSS	nl kzss
UEGL, SY	uegl sy
P, AY	p ay
RTP, W	rtp w
VGHIYSDOR, EK	vghiysdor ek
SJSSYFLM, JH	sjssyflm jh
A, F	a f
TXVPC, A	txvpc a
QKO, KSD	qko ksd
Q, IN	q in
LYC, IZO	lyc izo
HEAZN, GTNR	heazn gtnr
QNH, PT	qnh pt
LU, WG	lu wg
G, K	g k
NO, AX	no ax
NHZ, KN	nhz kn
AW, UP	aw up
O, UH	o uh
QOCBH, M	qocbh m
O, RID	o rid
PPLYBPYD, JJ	pplybpyd jj
TIJO, T	tijo t
GBDFFLSLVI, H	gbdfflslvi h
FAC, JNFLGYGI	fac jnflgygi
S, WHBI	s whbi
AY, LWPZJDR	ay lwpzjdr
UVS, J	uvs j
G, QM	g qm
CQG, KAZIW	cqg kaziw
GCD, M	gcd m
YOTV, Z	yotv z
LB, QNB	lb qnb
FT, MXUE	ft mxue
AE, T	ae t
IHJE, PY	ihje py
BCN, BYOKV	bcn byokv
W, T	w t
SVTZDQZJ, H	svtzdqzj h
CD, RC	cd rc
S, EWHRUV	s ewhruv
MM, IFH	mm ifh
WEU, DM	weu dm
XZ, IUAYED	xz iuayed
R, DIOYI	r dioyi
B, PFRS	b pfrs
T, CQTF	t cqtf
KIK, XSTE	kik xste
U, OZ	u oz
KMUQZ, PI	kmuqz pi
H, E	h e
WL, P	wl p
UHUL, ITGJZBXM	uhul itgjzbxm
HYTJY, JYI	hytjy jyi
ZRSTBQ, EXQ	zrstbq exq
H, Q	h q
C, NBS	c nbs
VM, HNGZQAAZGTQ	vm hngzqaazgtq
PN, ZX	pn zx
HHDKQ, Q	hhdkq q
OM, E	om e
AWGXDESD, VKB	awgxdesd vkb
BD, CGF	bd cgf
RM, TKSLFI	rm tkslfi
NJ, SVQOL	nj svqol
J, YB	j yb
DP, RHJ	dp rhj
J, LQA	j lqa
D, KR	d kr
R, QGO	r qgo
A, KGJVRBWEL	a kgjvrbwel
S, X	s x
YWD, HK	ywd hk
M, D	m d
W, KJSAV	w kjsav
ZCR, M	zcr m
P, L	p l
S, MJHB	s mjhb
FI, KX	fi kx
G, CKRB	g ckrb
DY, QKGKSA	dy qkgksa
Q, SZ	q sz
K, RJZSGG	k rjzsgg
JHIXEY, NZS	jhixey nzs
L, LLZC	l llzc
Y, IEC	y iec
G, HX	g hx
WNP, IEMRJ	wnp iemrj
R, U	r u
FLKFWNV, N	flkfwnv n
MFQ, T	mfq t
YRG, DOT	yrg dot
PPVVP, CGPK	ppvvp cgpk
L, OK	l ok
GQBE, TE	gqbe te
VOSNDH, G	vosndh g
VFGACNLT, W	vfgacnlt w
FZZNWACTM, PS	fzznwactm ps
V, N	v n
QWL, GR	qwl gr
ZSE, LI	zse li
EF, X	ef x
UE, QPOWF	ue qpowf
NF, M	nf m
MB, Z	mb z
E, V	e v
G, E	g e
ACATE, PZ	acate pz
HYH, SL	hyh sl
M, F	m f
MVBC, CEP	mvbc cep
O, A	o a
YB, HSL	yb hsl
GCS, L	gcs l
VRE, C	vre c
J, HJRWPQ	j hjrwpq
UXX, AK	uxx ak
GHMU, Y	ghmu y
AY, S	ay s
C, J	c j
Q, O	q o
JXW, E	jxw e
B, CGZZ	b cgzz
TZ, X	tz x
JYT, QJ	jyt qj
O, UW	o uw
EK, HP	ek hp
WI, G	wi g
NI, NR	ni nr
U, HK	u hk
P, Q	p q
JGFQ, DD	jgfq dd
BYSS, Q	byss q
W, BMF	w bmf
C, J	c j
PPTI, K	ppti k
OAV, IL	oav il
YLH, D	ylh d
LDU, CI	ldu ci
X, O	x o
D, F	d f
J, U	j u
AJXL, HLT	ajxl hlt
I, S	i s
CB, BA	cb ba
YTU, EWE	ytu ewe
EN, O	en o
T, SM	t sm
Y, BZ	y bz
OOL, WV	ool wv
DY, Q	dy q
BN, TDUF	bn tduf
I, DILDIU	i dildiu
XO, W	xo w
UKE, A	uke a
K, T	k t
X, YTZ	x ytz
NS, TF	ns tf
T, RN	t rn
A, W	a w
IRHFGR, VLFG	irhfgr vlfg
B, B	b b
D, GX	d gx
U, NX	u nx
AZ, JS	az js
GQ, YR	gq yr
P, MNDWPT	p mndwpt
DW, J	dw j
DAAWL, VI	daawl vi
VJUKE, N	vjuke n
ZLB, DQCRWNP	zlb dqcrwnp
NXI, V	nxi v
QKJ, V	qkj v
FWZ, QJM	fwz qjm
GKLKJ, XHE	gklkj xhe
LE, TCP	le tcp
ZR, J	zr j
F, DHN	f dhn
RA, U	ra u
R, M	r m
RQKYXFBPAT, DZNGVAKMSULB	rqkyxfbpat dzngvakmsulb
USDJ, QCG	usdj qcg
H, G	h g
P, C	p c
XNUVR, TUBW	xnuvr tubw
FF, D	ff d
U, BI	u bi
S, KOWM	s kowm
X, FJ	x fj
A, YIKHG	a yikhg
C, HON	c hon
GO, FK	go fk
RJ, VEHD	rj vehd
MOJJL, G	mojjl g
PKX, ITZQT	pkx itzqt
QN, ISTFFXV	qn istffxv
DYIWF, F	dyiwf f
MPTOU, PTUY	mptou ptuy
H, UT	h ut
N, VLAG	n vlag
QHQ, XC	qhq xc
ODRX, LA	odrx la
OT, YL	ot yl
V, USQ	v usq
N, TSJ	n tsj
DOZ, SLWM	doz slwm
RW, QM	rw qm
H, STWCQ	h stwcq
NUMKAE, WS	numkae ws
W, JRJ	w jrj
TBGDC, F	tbgdc f
XVU, EF	xvu ef
BA, KLLFH	ba kllfh
E, W	e w
U, Y	u y
H, XVAXNB	h xvaxnb
B, E	b e
LSS, VG	lss vg
RP, P	rp p
AQ, MMK	aq mmk
T, WJKQ	t wjkq
W, THRGY	w thrgy
P, LPOJ	p lpoj
CKGUAC, Q	ckguac q
ND, QWG	nd qwg
JSV, J	jsv j
E, UU	e uu
U, GO	u go
ADPL, W	adpl w
M, CBRM	m cbrm
ZWU, O	zwu o
GD, L	gd l
JNYDSX, GA	jnydsx ga
A, WESV	a wesv
X, DAA	x daa
Q, OH	q oh
H, HA	h ha
IJ, HOL	ij hol
L, EE	l ee
LP, UPNK	lp upnk
CWQ, LGX	cwq lgx
FJ, E	fj e
V, HC	v hc
D, ANXR	d anxr
KI, MZ	ki mz
TMZIXQEO, PAM	tmzixqeo pam
JI, D	ji d
OQ, ZNAAISC	oq znaaisc
L, S	l s
WH, M	wh m
J, DG	j dg
X, GF	x gf
SF, HBQ	sf hbq
QUJITZ, NHOYT	qujitz nhoyt
WLONORXM, ZVLNGGR	wlonorxm zvlnggr
H, CS	h cs
WHV, R	whv r
TRLWVLT, YAR	trlwvlt yar
H, IP	h ip
U, B	u b
T, NWAIHJU	t nwaihju
B, A	b a
VHEONFRL, Y	vheonfrl y
M, KYJGV	m kyjgv
NLK, YO	nlk yo
TH, I	th i
YRK, YSCI	yrk ysci
C, GLMOM	c glmom
HAOV, GGSGYUZJ	haov ggsgyuzj
G, Q	g q
YRPK, SASCDZSOS	yrpk sascdzsos
C, LNI	c lni
UO, I	uo i
GM, WS	gm ws
QCPV, SBBBGZUNBFJ	qcpv sbbbgzunbfj
IQF, P	iqf p
CXY, KJY	cxy kjy
O, OQ	o oq
HJZ, JH	hjz jh
F, H	f h
CCAPW, LVWYJ	ccapw lvwyj
CY, G	cy g
Y, ADJRTPPHWT	y adjrtpphwt
P, W	p w
W, ZN	w zn
WV, FOKPSF	wv fokpsf
V, HZJ	v hzj
FR, L	fr l
L, K	l k
R, LU	r lu
GR, YS	gr ys
WBQCX, SS	wbqcx ss
XI, TPV	xi tpv
ONHZGEU, YH	onhzgeu yh
MIZ, T	miz t
WNUS, N	wnus n
RE, LHWZLMKV	re lhwzlmkv
ZU, I	zu i
C, PBWX	c pbwx
SDO, RAR	sdo rar
PH, NYN	ph nyn
T, AW	t aw
F, G	f g
ZY, P	zy p
BAO, G	bao g
WLTTG, WHD	wlttg whd
V, W	v w
WXKI, RY	wxki ry
ZRA, IPCJFK	zra ipcjfk
N, Z	n z
JEWVQG, UJ	jewvqg uj
WD, FGKML	wd fgkml
ZA, WOE	za woe
SFIDHG, MNE	sfidhg mne
OGFTMBGOXNML, SKFM	ogftmbgoxnml skfm
P, W	p w
A, AR	a ar
CKE, CER	cke cer
J, K	j k
SP, E	sp e
UI, FX	ui fx
PG, CUW	pg cuw
GX, TD	gx td
W, D	w d
CV, DPY	cv dpy
D, TU	d tu
FEXJIFJFU, HKRV	fexjifjfu hkrv
LE, UOMA	le uoma
XQSXCMWS, FXASA	xqsxcmws fxasa
YM, Y	ym y
GXT, FI	gxt fi
TY, FXXK	ty fxxk
R, E	r e
G, O	g o
EFMVJ, G	efmvj g
U, ODDN	u oddn
IOWGQF, UZEENC	iowgqf uzeenc
MX, POEHC	mx poehc
II, OSY	ii osy
XQEZ, L	xqez l
YP, XWKHO	yp xwkho
IDF, A	idf a
QS, LRJTD	qs lrjtd
DWW, S	dww s
XG, BGYCQEZ	xg bgycqez
OMK, RJ	omk rj
PW, CHOCI	pw choci
J, OBYOL	j obyol
BHS, SD	bhs sd
X, QY	x qy
ZMRQEFIUG, OMCP	zmrqefiug omcp
UZ, H	uz h
G, J	g j
LDSKJ, P	ldskj p
JK, V	jk v
RTY, JBL	rty jbl
AL, ZR	al zr
CQMA, QTG	cqma qtg
F, M	f m
X, X	x x
VB, QBPJLWGBBW	vb qbpjlwgbbw
C, T	c t
SJ, ICP	sj icp
JD, MGJXYDKXXG	jd mgjxydkxxg
OK, JGRL	ok jgrl
O, J	o j
ITEKZ, O	itekz o
I, Y	i y
EAIZS, BI	eaizs bi
F, XRPBZ	f xrpbz
IX, CV	ix cv
LF, N	lf n
JI, PM	ji pm
PY, G	py g
X, IDCO	x idco
XB, PZ	xb pz
X, D	x d
ZZN, W	zzn w
O, Z	o z
CSQ, S	csq s
TKIFM, TQ	tkifm tq
ZNPKCAB, HFYDD	znpkcab hfydd
N, ET	n et
C, J	c j
Y, WR	y wr
HC, X	hc x
IH, YUR	ih yur
XXPQ, XM	xxpq xm
UA, S	ua s
EA, ONMOMCFYT	ea onmomcfyt
QPM, Q	qpm q
FT, A	ft a
LMU, P	lmu p
B, G	b g
ATNC, FNDNC	atnc fndnc
V, H	v h
BAPE, Y	bape y
KBI, TPLP	kbi tplp
K, HSZ	k hsz
J, ZSP	j zsp
J, TY	j ty
QS, SR	qs sr
D, MRL	d mrl
I, CL	i cl
BIZ, FORICZMZG	biz foriczmzg
O, F	o f
J, CEHVLANC	j cehvlanc
FYVHR, W	fyvhr w
BXT, Z	bxt z
Y, XJKWVEU	y xjkwveu
C, PT	c pt
OIE, UH	oie uh
O, XQ	o xq
K, FVY	k fvy
S, KZRUF	s kzruf
ZL, U	zl u
H, WFRE	h wfre
SEDJKI, CQL	sedjki cql
A, O	a o
CR, QLJAK	cr qljak
JU, V	ju v
I, O	i o
G, I	g i
GQ, UB	gq ub
IJXOCM, G	ijxocm g
YLLQKI, RDCEWF	yllqki rdcewf
MG, GKO	mg gko
D, H	d h
J, ZG	j zg
FVNNZWDJPKBGX, AB	fvnnzwdjpkbgx ab
F, QEQ	f qeq
EX, W	ex w
H, CUHYS	h cuhys
YF, HGI	yf hgi
MVMGKZ, ZGRBFPCRNYBL	mvmgkz zgrbfpcrnybl
M, JR	m jr
G, J	g j
PNVTL, YHC	pnvtl yhc
E, S	e s
C, H	c h
MKH, A	mkh a
OH, ZO	oh zo
FWFH, O	fwfh o
GN, HCV	gn hcv
W, CM	w cm
SPM, D	spm d
GU, C	gu c
VWU, R	vwu r
MW, JJWWYZ	mw jjwwyz
ZS, ZC	zs zc
B, CXWQFQBH	b cxwqfqbh
LJVA, MLIO	ljva mlio
LSTUSPV, GET	lstuspv get
R, X	r x
CYX, VOZDWBWRW	cyx vozdwbwrw
T, COSZIBDFS	t coszibdfs
HQER, TT	hqer tt
LE, XDMCHSWPI	le xdmchswpi
A, J	a j
S, A	s a
E, IM	e im
OB, RO	ob ro
CY, ZD	cy zd
WAH, KAZ	wah kaz
FV, QTNZNEF	fv qtnznef
HD, HRT	hd hrt
QHKA, D	qhka d
A, HQ	a hq
G, S	g s
V, LRXL	v lrxl
B, Q	b q
NISF, N	nisf n
CKINSTTAQGDIKVSX, KDYP	ckinsttaqgdikvsx kdyp
EJMWP, XGNPDSW	ejmwp xgnpdsw
XP, IYVJE	xp iyvje
U, ZWVZ	u zwvz
YD, T	yd t
KR, ZWQH	kr zwqh
F, O	f o
WHGTD, V	whgtd v
OBN, W	obn w
XNT, C	xnt c
O, VHGASXFT	o vhgasxft
Z, X	z x
Y, R	y r
KGFSJVDLUORL, H	kgfsjvdluorl h
Q, NKF	q nkf
IGP, QMU	igp qmu
FFVGY, KA	ffvgy ka
RPPPNC, S	rpppnc s
F, NC	f nc
BW, UEE	bw uee
XIXS, EBQO	xixs ebqo
R, ESNN	r esnn
VV, SWOR	vv swor
WD, M	wd m
E, FG	e fg
UXDE, N	uxde n
X, YMYPJ	x ymypj
GI, HO	gi ho
O, ZXVYHP	o zxvyhp
T, Z	t z
YEU, LWXMAS	yeu lwxmas
K, V	k v
MTLDBZA, COOP	mtldbza coop
TJ, G	tj g
J, PB	j pb
MA, GW	ma gw
ZHW, A	zhw a
R, XZ	r xz
W, UANS	w uans
ZXG, V	zxg v
MX, R	mx r
XKH, SZKD	xkh szkd
ISI, TGIFZUT	isi tgifzut
LN, F	ln f
W, EJ	w ej
JLR, E	jlr e
NAQD, UX	naqd ux
PH, YYNDUOZ	ph yynduoz
W, X	w x
HCX, E	hcx e
LWEVD, B	lwevd b
PI, S	pi s
XBZJ, YG	xbzj yg
PYFA, Q	pyfa q
H, VO	h vo
ROR, NI	ror ni
SSZ, X	ssz x
LCHR, JIEQ	lchr jieq
L, N	l n
RXL, P	rxl p
O, AZ	o az
U, O	u o
B, IU	b iu
EX, L	ex l
LZL, KBJ	lzl kbj
YRQS, Y	yrqs y
YBMLOJ, V	ybmloj v
OL, O	ol o
MRCRP, OMRJSJCH	mrcrp omrjsjch
U, RZTMWCQUFAVQH	u rztmwcqufavqh
SE, LNGAKX	se lngakx
WFRGWYTH, N	wfrgwyth n
KK, HM	kk hm
QR, V	qr v
SK, I	sk i
LOXWM, TYW	loxwm tyw
EJ, I	ej i
W, PM	w pm
D, QDRVF	d qdrvf
ZP, BR	zp br
UJC, U	ujc u
F, BLPX	f blpx
M, T	m t
A, C	a c
B, UN	b un
GX, AG	gx ag
X, VRPAJT	x vrpajt
A, X	a x
ZEMS, WQHD	zems wqhd
S, JV	s jv
HA, DDDA	ha ddda
H, L	h l
UVGSCC, Q	uvgscc q
Y, G	y g
A, V	a v
TO, SCM	to scm
OJXQPI, K	ojxqpi k
ATTME, GZ	attme gz
G, TC	g tc
VT, RF	vt rf
CEEGYXM, XK	ceegyxm xk
HDZ, YSLHV	hdz yslhv
KQT, PNKJZ	kqt pnkjz
ATDM, LLP	atdm llp
NB, D	nb d
FIYD, V	fiyd v
CZ, PFIFM	cz pfifm
KSNOULL, EPI	ksnoull epi
A, RY	a ry
RHBSKR, V	rhbskr v
CN, SC	cn sc
PESZDTY, L	peszdty l
IRZU, ZF	irzu zf
G, WLW	g wlw
V, I	v i
Z, UI	z ui
Z, OF	z of
VM, Y	vm y
K, NRG	k nrg
C, RBJBMMRHJWEIKN	c rbjbmmrhjweikn
FU, JJK	fu jjk
J, KAVS	j kavs
M, I	m i
PHA, UW	pha uw
S, Z	s z
VK, W	vk w
VCR, LDM	vcr ldm
U, YFZK	u yfzk
IJ, LGO	ij lgo
O, BEL	o bel
H, CGDY	h cgdy
AEYS, QL	aeys ql
D, VQJY	d vqjy
A, X	a x
C, E	c e
MSNGO, RWG	msngo rwg
E, W	e w
A, U	a u
SEO, VGMSS	seo vgmss
IZ, G	iz g
B, KJ	b kj
ZJ, T	zj t
F, PN	f pn
N, O	n o
UOUO, U	uouo u
C, XEOEF	c xeoef
T, PD	t pd
ME, P	me p
BXN, M	bxn m
EUHNMS, Q	euhnms q
Z, P	z p
RQA, YT	rqa yt
W, OG	w og
BHQPR, RLPQL	bhqpr rlpql
VKBJJ, T	vkbjj t
BS, DK	bs dk
TJP, RGA	tjp rga
M, D	m d
BFUON, RCBXDJGCD	bfuon rcbxdjgcd
N, XKA	n xka
PRX, G	prx g
PIXV, G	pixv g
G, FK	g fk
GE, IJIAT	ge ijiat
W, O	w o
LX, UN	lx un
O, PS	o ps
T, G	t g
ODV, P	odv p
PH, Q	ph q
T, FT	t ft
OWN, OA	own oa
IRU, DP	iru dp
E, ERD	e erd
QI, OVDR	qi ovdr
D, WGL	d wgl
B, OYYD	b oyyd
DYLA, DCEXFUFO	dyla dcexfufo
XH, NM	xh nm
XUOJ, NX	xuoj nx
RH, Y	rh y
VDZ, HY	vdz hy
HVCEH, AA	hvceh aa
P, BB	p bb
P, K	p k
FZ, YJD	fz yjd
U, YO	u yo
ESXORYHJ, J	esxoryhj j
O, PK	o pk
G, P	g p
D, OUL	d oul
A, QHZ	a qhz
V, POUEJ	v pouej
V, IL	v il
VV, LTQ	vv ltq
AH, KR	ah kr
K, Q	k q
V, MRXE	v mrxe
XV, D	xv d
N, WEUT	n weut
Q, FWRJL	q fwrjl
CMXV, MA	cmxv ma
LDME, CQH	ldme cqh
YMX, K	ymx k
XK, YJCL	xk yjcl
FVE, G	fve g
B, B	b b
UEP, GOS	uep gos
D, JXL	d jxl
XLU, X	xlu x
A, SRTKX	a srtkx
X, LRIHTU	x lrihtu
YU, NTY	yu nty
F, Q	f q
OJ, CLQZM	oj clqzm
E, SVT	e svt
IPB, G	ipb g
GA, STE	ga ste
VU, NCD	vu ncd
YXYEFGHBA, D	yxyefghba d
G, HZF	g hzf
N, UJ	n uj
C, J	c j
T, COZB	t cozb
I, LELUYS	i leluys
K, KDYT	k kdyt
XSUJD, X	xsujd x
ZPH, JL	zph jl
WTWG, BY	wtwg by
V, G	v g
K, T	k t
PKI, MD	pki md
U, Z	u z
XVE, L	xve l
URWZKV, NB	urwzkv nb
AK, TWIKH	ak twikh
M, TCN	m tcn
JPEI, NAF	jpei naf
V, L	v l
A, YK	a yk
BPLTOIV, HS	bpltoiv hs
X, YRPAK	x yrpak
SL, JX	sl jx
FQG, B	fqg b
R, C	r c
QK, SD	qk sd
H, ZL	h zl
NQ, DGG	nq dgg
M, E	m e
U, OF	u of
YWO, KQ	ywo kq
RQJS, JQLKU	rqjs jqlku
QD, R	qd r
N, A	n a
PEOA, Y	peoa y
GUX, LUL	gux lul
GLRMIJ, CJU	glrmij cju
P, CEOIDV	p ceoidv
AIIH, CP	aiih cp
N, H	n h
CXLF, UC	cxlf uc
J, Y	j y
J, E	j e
IVY, QY	ivy qy
JW, E	jw e
L, M	l m
CFL, Z	cfl z
JKM, R	jkm r
V, QD	v qd
GVQ, GA	gvq ga
PVZW, G	pvzw g
K, TB	k tb
HSWPOU, LZILQTG	hswpou lzilqtg
RCUG, WFC	rcug wfc
Z, YY	z yy
M, VSVAP	m vsvap
F, RL	f rl
A, PGX	a pgx
F, ZRRSLNZ	f zrrslnz
YNFDH, PBX	ynfdh pbx
N, DYR	n dyr
G, O	g o
D, DPSMTTFEQ	d dpsmttfeq
MRH, MQV	mrh mqv
JDRV, O	jdrv o
AQYJ, G	aqyj g
DD, ZD	dd zd
K, M	k m
QOHV, O	qohv o
OB, H	ob h
QTUUD, FVQOA	qtuud fvqoa
WP, A	wp a
NFJV, QCJ	nfjv qcj
XB, H	xb h
U, C	u c
PAF, KZ	paf kz
WRF, C	wrf c
IR, JY	ir jy
EFY, TMLUIX	efy tmluix
O, T	o t
ZINTUA, GY	zintua gy
SS, UVY	ss uvy
O, FK	o fk
T, JX	t jx
EX, K	ex k
J, MBH	j mbh
L, VMGRPLH	l vmgrplh
UG, O	ug o
EIX, X	eix x
JA, KX	ja kx
Q, WY	q wy
ES, G	es g
XZ, N	xz n
V, VH	v vh
LH, O	lh o
JBTGA, NZO	jbtga nzo
SWQBEB, ER	swqbeb er
NHMD, V	nhmd v
OXY, FVZ	oxy fvz
CXR, OJR	cxr ojr
HBQY, BKQ	hbqy bkq
OBZOGZZ, PZEA	obzogzz pzea
GGQR, S	ggqr s
R, IQF	r iqf
NDXW, H	ndxw h
I, I	i i
DK, G	dk g
XUEV, ISVX	xuev isvx
C, I	c i
SAXDQ, D	saxdq d
J, O	j o
W, N	w n
HV, LZU	hv lzu
J, AUGMX	j augmx
R, JNB	r jnb
CEJ, ZX	cej zx
JPQPQDCXRUMFF, M	jpqpqdcxrumff m
XIEJ, XGZ	xiej xgz
YYMOX, HTZ	yymox htz
PDJEZGAQC, WL	pdjezgaqc wl
F, YAY	f yay
P, L	p l
T, PA	t pa
WHQ, G	whq g
MICYV, JASVMIF	micyv jasvmif
U, FENZ	u fenz
GD, R	gd r
SCIMESJ, U	scimesj u
H, YXT	h yxt
X, S	x s
MB, OIPILA	mb oipila
S, OK	s ok
XA, VV	xa vv
N, P	n p
FZZY, IVN	fzzy ivn
E, LUEUBDHTDG	e lueubdhtdg
AN, CH	an ch
U, J	u j
UDU, C	udu c
IW, NZVB	iw nzvb
P, LYU	p lyu
J, F	j f
N, C	n c
KM, A	km a
EAML, WGUW	eaml wguw
L, A	l a
K, EM	k em
GSU, HC	gsu hc
J, RBEIR	j rbeir
Z, I	z i
AGXYFNGSVLYG, CNY	agxyfngsvlyg cny
I, UYZTOLG	i uyztolg
CMUQ, HZS	cmuq hzs
KM, V	km v
CIP, HM	cip hm
LJT, H	ljt h
JD, WGY	jd wgy
NE, XQ	ne xq
F, BZ	f bz
Z, X	z x
JC, BQM	jc bqm
QEIO, P	qeio p
LTW, Q	ltw q
DZ, H	dz h
UAMCIG, MN	uamcig mn
M, M	m m
DJ, HABMK	dj habmk
ZVWZZJ, R	zvwzzj r
OKA, G	oka g
FK, XXE	fk xxe
L, S	l s
PF, Y	pf y
Z, ITTYNNHYPO	z ittynnhypo
J, C	j c
RRQXTBPOORDAS, BK	rrqxtbpoordas bk
N, X	n x
Q, N	q n
IC, QN	ic qn
QU, W	qu w
Y, TN	y tn
LXMC, R	lxmc r
NN, F	nn f
FJ, U	fj u
DL, MW	dl mw
LOMXR, QJD	lomxr qjd
YS, XA	ys xa
EUM, D	eum d
B, H	b h
BN, WL	bn wl
BF, A	bf a
SJQUIN, TTRFY	sjquin ttrfy
MZAWZRKJTD, HV	mzawzrkjtd hv
STZE, NIKTNK	stze niktnk
GLHJLJ, F	glhjlj f
Q, EJ	q ej
Y, R	y r
B, W	b w
Y, OBTXM	y obtxm
SGOZ, G	sgoz g
R, BG	r bg
RUSU, VN	rusu vn
PJ, G	pj g
O, NV	o nv
DO, NO	do no
IY, L	iy l
MJH, RP	mjh rp
WM, H	wm h
C, KQX	c kqx
VGQMTE, RTTOF	vgqmte rttof
COG, JLOX	cog jlox
BT, RO	bt ro
VA, R	va r
XFC, Y	xfc y
W, ATM	w atm
VH, AUGIF	vh augif
X, R	x r
QA, W	qa w
QQ, M	qq m
E, IUW	e iuw
FJ, KE	fj ke
P, OE	p oe
WXQ, LPU	wxq lpu
H, ND	h nd
GA, GHL	ga ghl
JCVI, SEG	jcvi seg
X, KD	x kd
SOKY, Q	soky q
F, E	f e
LJ, Z	lj z
O, KHFKHQ	o khfkhq
EDD, MAKK	edd makk
T, MV	t mv
ZVDK, KAX	zvdk kax
TVPJ, XMAM	tvpj xmam
S, IEG	s ieg
JFHMBAC, BM	jfhmbac bm
HSKDDMUWVE, UQT	hskddmuwve uqt
O, DA	o da
H, BW	h bw
YODEA, C	yodea c
ZW, UNMVXG	zw unmvxg
S, H	s h
L, L	l l
V, T	v t
AP, I	ap i
D, W	d w
G, EI	g ei
S, JIQWLXKTHECC	s jiqwlxkthecc
ZOFH, S	zofh s
CF, OOT	cf oot
AV, XLC	av xlc
GQAOK, Q	gqaok q
E, E	e e
IO, Z	io z
MBRNODVV, H	mbrnodvv h
IJ, UUX	ij uux
NWHWTZ, HST	nwhwtz hst
CQK, WOX	cqk wox
Y, MK	y mk
E, O	e o
WLPIGH, OBA	wlpigh oba
DV, VX	dv vx
R, ZH	r zh
G, IXQ	g ixq
CU, VR	cu vr
L, HUP	l hup
JC, TGF	jc tgf
AQNQ, ZC	aqnq zc
X, AAA	x aaa
YFKTH, UNPZB	yfkth unpzb
KAIY, YK	kaiy yk
NB, FU	nb fu
D, YMNF	d ymnf
RLJ, N	rlj n
CJK, X	cjk x
UDW, JZDX	udw jzdx
NE, VBG	ne vbg
WYN, MF	wyn mf
EOW, ZR	eow zr
M, EPH	m eph
IT, VRIQZMZQI	it vriqzmzqi
HI, AXAU	hi axau
M, V	m v
A, SE	a se
XJGKQ, C	xjgkq c
NLTPG, M	nltpg m
X, FB	x fb
P, Q	p q
I, TC	i tc
BSG, O	bsg o
MXQC, LKQYI	mxqc lkqyi
N, A	n a
WWXBMIOF, B	wwxbmiof b
IAYXGFPEM, Y	iayxgfpem y
KEPKNO, ZXTZ	kepkno zxtz
NKRSTY, J	nkrsty j
JP, R	jp r
VJAS, XLF	vjas xlf
S, J	s j
V, W	v w
YC, HNG	yc hng
WSL, GANF	wsl ganf
P, UD	p ud
W, C	w c
C, EQ	c eq
UL, NT	ul nt
HNI, S	hni s
OYO, UT	oyo ut
L, NKZ	l nkz
C, KZ	c kz
A, PK	a pk
L, D	l d
U, T	u t
KJIHURAOS, I	kjihuraos i
YJ, ZB	yj zb
L, L	l l
PJ, I	pj i
Y, RQLH	y rqlh
O, N	o n
LS, CXXB	ls cxxb
Z, MZTCNPODZD	z mztcnpodzd
P, XW	p xw
STUAK, AO	stuak ao
ES, CRDUP	es crdup
E, PLC	e plc
PM, QC	pm qc
H, A	h a
FF, HUGZEHVNDY	ff hugzehvndy
P, DT	p dt
QDLUZ, GUZXBFYVOIN	qdluz guzxbfyvoin
H, GKZYGQ	h gkzygq
KZ, AYD	kz ayd
JXX, WYWEN	jxx wywen
U, Z	u z
PX, Y	px y
B, JB	b jb
Z, T	z t
EC, GWHSE	ec gwhse
WFA, GM	wfa gm
OL, IX	ol ix
QR, NXIZT	qr nxizt
MSFB, AMVR	msfb amvr
YLG, QT	ylg qt
WY, VN	wy vn
ER, CM	er cm
N, UHN	n uhn
UKOER, N	ukoer n
RHTA, RWAAAH	rhta rwaaah
K, QZ	k qz
WUQ, QRGEMQ	wuq qrgemq
YVN, I	yvn i
KXQ, UY	kxq uy
XCM, WX	xcm wx
Y, QQ	y qq
BS, X	bs x
A, J	a j
LAS, PKNGF	las pkngf
B, MW	b mw
LKLUG, ZTO	lklug zto
UE, H	ue h
XGML, SDCU	xgml sdcu
HJ, R	hj r
I, I	i i
TJF, RFV	tjf rfv
YPFT, Z	ypft z
KVEC, I	kvec i
HI, FQF	hi fqf
UK, KX	uk kx
LO, GO	lo go
T, VWO	t vwo
P, FSD	p fsd
SVZGXR, XQC	svzgxr xqc
Z, QKAKPXPY	z qkakpxpy
NJ, T	nj t
UQZ, UV	uqz uv
C, E	c e
OWCH, ANZ	owch anz
XFR, YKL	xfr ykl
SF, RKB	sf rkb
I, V	i v
EZQ, MSJSQ	ezq msjsq
FP, MDI	fp mdi
TDIY, C	tdiy c
O, Y	o y
LL, B	ll b
ED, GUKBHS	ed gukbhs
Q, JGDO	q jgdo
KA, K	ka k
JR, G	jr g
F, HHPU	f hhpu
S, BTDDUM	s btddum
XM, GM	xm gm
KWPBHV, I	kwpbhv i
G, V	g v
N, VAE	n vae
IGTPF, PY	igtpf py
PM, FPCAJ	pm fpcaj
OIH, J	oih j
K, UR	k ur
LMR, YDUK	lmr yduk
C, Y	c y
UB, YW	ub yw
HSLBYT, C	hslbyt c
FEV, Q	fev q
CU, Y	cu y
S, EZG	s ezg
K, W	k w
Y, K	y k
H, AY	h ay
EQ, I	eq i
MO, UBC	mo ubc
ELH, PWQKX	elh pwqkx
IM, G	im g
H, X	h x
XBZFE, L	xbzfe l
RBAKSJ, PTZ	rbaksj ptz
PKI, R	pki r
YOZ, BG	yoz bg
X, F	x f
QOB, OU	qob ou
F, S	f s
Y, ZH	y zh
HP, FJZVA	hp fjzva
IVHLZDPQID, DA	ivhlzdpqid da
GPV, Y	gpv y
PT, HN	pt hn
F, Y	f y
UUFT, E	uuft e
Y, SAONFHXA	y saonfhxa
KU, C	ku c
SJVCZ, YPCAH	sjvcz ypcah
SNR, HJP	snr hjp
NM, QTPDY	nm qtpdy
GKQVOU, HQT	gkqvou hqt
G, NUQ	g nuq
XCL, QT	xcl qt
H, NQRI	h nqri
W, PQC	w pqc
PI, JO	pi jo
Y, P	y p
Q, O	q o
J, YGTGTMVXAHSD	j ygtgtmvxahsd
TWW, PLZZ	tww plzz
TUVPOGBN, AO	tuvpogbn ao
K, JW	k jw
ORWWR, B	orwwr b
M, H	m h
V, C	v c
MWWXFJ, P	mwwxfj p
DSA, B	dsa b
PUIWX, H	puiwx h
R, SFUDFSM	r sfudfsm
LQ, QELLF	lq qellf
YR, Q	yr q
I, AAQ	i aaq
NI, QERMFNWKZM	ni qermfnwkzm
LF, G	lf g
J, P	j p
YPGX, ICUVOP	ypgx icuvop
ZJ, HM	zj hm
PV, HXV	pv hxv
Q, ZFAC	q zfac
HOF, PUTG	hof putg
K, K	k k
HFFFMR, RRUD	hfffmr rrud
FWO, O	fwo o
IZL, U	izl u
Y, SAOM	y saom
AOY, QEYKCJS	aoy qeykcjs
AEOXD, PPLFG	aeoxd pplfg
NJXJDLP, M	njxjdlp m
R, GDAAGIH	r gdaagih
TQEPDAP, MP	tqepdap mp
EO, N	eo n
E, Y	e y
QXPV, R	qxpv r
CO, OSG	co osg
BT, PUI	bt pui
E, DEG	e deg
HQI, N	hqi n
H, MS	h ms
E, AHL	e ahl
ORDY, YK	ordy yk
N, HPC	n hpc
YD, PQ	yd pq
Q, F	q f
ITL, BY	itl by
OOPM, ONXYKN	oopm onxykn
Z, ET	z et
CGE, OU	cge ou
JNB, T	jnb t
XP, DNZKL	xp dnzkl
Q, X	q x
SE, M	se m
W, QJD	w qjd
V, M	v m
G, XIIQWOL	g xiiqwol
Z, AGWERUFQRUQIU	z agwerufqruqiu
M, ETN	m etn
L, V	l v
J, Z	j z
H, QU	h qu
PF, F	pf f
MC, TX	mc tx
I, EA	i ea
PGWP, CHKIP	pgwp chkip
DH, A	dh a
KG, O	kg o
K, HNBGO	k hnbgo
U, UWVMMA	u uwvmma
M, RDL	m rdl
WJH, JPT	wjh jpt
PMNXBYK, L	pmnxbyk l
SU, GK	su gk
Y, R	y r
H, K	h k
QT, OAF	qt oaf
BQO, O	bqo o
LVL, V	lvl v
C, JPLJ	c jplj
AR, HUVAR	ar huvar
MT, ZGA	mt zga
N, AKFMNLGXKM	n akfmnlgxkm
ESN, EH	esn eh
XU, W	xu w
B, RVW	b rvw
YJZHA, H	yjzha h
L, RRN	l rrn
FB, F	fb f
XYQSL, H	xyqsl h
OX, JA	ox ja
MM, S	mm s
KJMHU, XZ	kjmhu xz
X, ZLXUT	x zlxut
VC, VF	vc vf
JDDS, ZFM	jdds zfm
WEP, AY	wep ay
UR, G	ur g
NHQ, KZ	nhq kz
AWEX, EHODSF	awex ehodsf
SMSGZ, C	smsgz c
WITJCXOQI, MCMU	witjcxoqi mcmu
BMM, ILAV	bmm ilav
Y, N	y n
THG, E	thg e
QR, XMQWC	qr xmqwc
QVC, P	qvc p
UTI, M	uti m
A, H	a h
U, MHPJZN	u mhpjzn
Y, H	y h
HPV, YJL	hpv yjl
W, LLM	w llm
HZ, EXO	hz exo
CY, V	cy v
Z, G	z g
N, CTWL	n ctwl
NVV, EK	nvv ek
L, E	l e
ALOT, MD	alot md
Q, K	q k
XI, QDVN	xi qdvn
AJ, YDXX	aj ydxx
T, S	t s
ZJOXQS, A	zjoxqs a
S, PE	s pe
EVGW, J	evgw j
GPPSSNERE, VKIAW	gppssnere vkiaw
L, TJEN	l tjen
LR, NIOWWJDVNPCA	lr niowwjdvnpca
FU, ZX	fu zx
QO, R	qo r
S, T	s t
OWWG, P	owwg p
F, XGE	f xge
GMWOHEG, X	gmwoheg x
BC, EMP	bc emp
RF, B	rf b
JUA, IPY	jua ipy
S, IE	s ie
N, S	n s
GV, J	gv j
Q, F	q f
OP, UNTJP	op untjp
XFA, MVW	xfa mvw
CQDT, I	cqdt i
IPA, XB	ipa xb
W, T	w t
SY, BLKU	sy blku
VXQDXLC, ZAJ	vxqdxlc zaj
D, LUH	d luh
DE, RNR	de rnr
EHKUPNJ, Z	ehkupnj z
FP, TD	fp td
CKG, W	ckg w
YJ, DNQ	yj dnq
U, N	u n
G, Y	g y
M, K	m k
QURT, FE	qurt fe
ZOFM, D	zofm d
NDZUFMWRNKC, M	ndzufmwrnkc m
XIT, M	xit m
G, DBP	g dbp
A, OANLI	a oanli
RCSL, BB	rcsl bb
GW, Z	gw z
PW, A	pw a
IA, EZ	ia ez
YC, I	yc i
F, RAFYU	f rafyu
DYN, PIEO	dyn pieo
EU, IV	eu iv
RMT, O	rmt o
GCCNMNXR, KOBXNR	gccnmnxr kobxnr
ZPHT, F	zpht f
J, YF	j yf
RHHE, TTZIEG	rhhe ttzieg
L, NM	l nm
J, XJBLQPX	j xjblqpx
U, A	u a
V, G	v g
Z, ZA	z za
MBRNTYN, FTU	mbrntyn ftu
EN, J	en j
I, F	i f
WVTURGO, E	wvturgo e
I, Q	i q
I, Q	i q
WM, V	wm v
D, LODDN	d loddn
R, I	r i
S, EQ	s eq
M, LN	m ln
K, B	k b
NFERCG, U	nfercg u
RXQBX, UFEDWY	rxqbx ufedwy
YLHYE, TZS	ylhye tzs
I, T	i t
X, GJR	x gjr
I, BV	i bv
PSG, Y	psg y
SHGP, LUZXBVI	shgp luzxbvi
XVJ, O	xvj o
WYQJYG, IV	wyqjyg iv
SO, KLEXRCJM	so klexrcjm
GF, RCXT	gf rcxt
R, JX	r jx
L, NHXL	l nhxl
A, SEWJ	a sewj
GNR, UPF	gnr upf
KB, BDJYPD	kb bdjypd
Z, NY	z ny
DBR, M	dbr m
S, P	s p
LQVSDVW, JHHX	lqvsdvw jhhx
M, W	m w
EOQGM, Z	eoqgm z
A, NUP	a nup
KX, MH	kx mh
JZGVHUKSA, CCYM	jzgvhuksa ccym
VA, QWA	va qwa
WCE, BQT	wce bqt
NPK, B	npk b
X, O	x o
H, FCOGJ	h fcogj
J, J	j j
MOCHAS, IVOI	mochas ivoi
NFUAN, C	nfuan c
VH, M	vh m
KQM, HPF	kqm hpf
E, Q	e q
JXOT, XEH	jxot xeh
AVN, S	avn s
WBIWR, DX	wbiwr dx
S, RDNLROXYFNJOKC	s rdnlroxyfnjokc
SBX, GI	sbx gi
W, IZX	w izx
SEQO, V	seqo v
CQTAMJ, B	cqtamj b
AY, B	ay b
XWSQOI, ME	xwsqoi me
LQH, L	lqh l
EL, QJU	el qju
B, E	b e
W, TO	w to
X, TZE	x tze
NGFY, ZDYNXODM	ngfy zdynxodm
TY, T	ty t
ZH, EC	zh ec
QT, OL	qt ol
V, SMI	v smi
C, NMPRXR	c nmprxr
GZ, RTI	gz rti
T, V	t v
Q, B	q b
L, JYF	l jyf
OY, T	oy t
VPUIQN, UG	vpuiqn ug
P, N	p n
LJL, UN	ljl un
PX, W	px w
IAXXNNMTCO, AHW	iaxxnnmtco ahw
CX, MV	cx mv
MS, ATXQR	ms atxqr
TPNMQ, IUEWDT	tpnmq iuewdt
M, LBTP	m lbtp
KWNBNKIPGV, TEC	kwnbnkipgv tec
U, J	u j
GCT, R	gct r
I, G	i g
B, F	b f
HQ, OS	hq os
K, V	k v
W, HT	w ht
OMJ, A	omj a
IERD, C	ierd c
N, J	n j
J, X	j x
HP, RP	hp rp
Y, L	y l
XP, Y	xp y
Z, SOAZM	z soazm
JXCE, B	jxce b
GEILO, C	geilo c
MWY, DV	mwy dv
MI, M	mi m
D, ZE	d ze
VTOLLCUF, M	vtollcuf m
DU, G	du g
BGI, JUEHU	bgi juehu
M, WZ	m wz
S, X	s x
F, QT	f qt
P, S	p s
VWUP, FNKQRE	vwup fnkqre
V, C	v c
G, ZV	g zv
IU, YB	iu yb
XY, S	xy s
Q, BG	q bg
A, RU	a ru
KTHHM, FCNMH	kthhm fcnmh
W, B	w b
K, V	k v
PRI, SY	pri sy
V, MHZCN	v mhzcn
SLUYTXO, FYKO	sluytxo fyko
XOP, USXOM	xop usxom
OA, E	oa e
RU, WDBGHQJ	ru wdbghqj
APFVAP, KKL	apfvap kkl
YB, O	yb o
UW, WCEP	uw wcep
I, D	i d
P, ASYXIQU	p asyxiqu
WP, LC	wp lc
MQLADJ, L	mqladj l
LPMP, YBC	lpmp ybc
OK, L	ok l
EIJKGWDO, YGO	eijkgwdo ygo
AP, KP	ap kp
Y, DEZW	y dezw
U, QY	u qy
P, V	p v
U, R	u r
JZUN, HF	jzun hf
KPH, KDO	kph kdo
O, MSA	o msa
SRGJY, F	srgjy f
B, LI	b li
FWNZQU, GDVGOQ	fwnzqu gdvgoq
E, Y	e y
XMCC, Z	xmcc z
ZQD, J	zqd j
F, U	f u
Q, GR	q gr
EI, ZS	ei zs
G, BW	g bw
B, C	b c
NAB, MHS	nab mhs
VQ, UH	vq uh
R, AFQ	r afq
HSKKE, BWU	hskke bwu
WW, B	ww b
M, NIO	m nio
HWZICQ, F	hwzicq f
VNBE, O	vnbe o
BHEC, BQ	bhec bq
WGCDZSOE, C	wgcdzsoe c
F, F	f f
I, TJWMA	i tjwma
BTD, YOW	btd yow
S, OUXTKWEWU	s ouxtkwewu
VI, G	vi g
AKR, T	akr t
P, QF	p qf
BJDM, DD	bjdm dd
C, SY	c sy
SGPB, V	sgpb v
T, W	t w
F, GWG	f gwg
SSU, IU	ssu iu
IZ, ZJKMHDI	iz zjkmhdi
Z, ELMMFBD	z elmmfbd
R, Z	r z
ZSXBL, ZZUKZ	zsxbl zzukz
KK, I	kk i
YG, YE	yg ye
H, QZLG	h qzlg
PJKG, WKCL	pjkg wkcl
EJC, H	ejc h
Y, OGI	y ogi
DS, UP	ds up
MXHA, Y	mxha y
LHAG, TDV	lhag tdv
RMN, VBP	rmn vbp
VYOKUR, XJ	vyokur xj
F, S	f s
AG, OX	ag ox
BUR, Q	bur q
KJW, MWD	kjw mwd
UTIO, V	utio v
BRMZLUM, E	brmzlum e
OQFX, L	oqfx l
JO, QW	jo qw
NM, V	nm v
L, K	l k
K, QSC	k qsc
IB, E	ib e
SUOJAD, QCJ	suojad qcj
FVLNCVFLHGMSCL, YM	fvlncvflhgmscl ym
AFZG, WT	afzg wt
UJ, WB	uj wb
TO, O	to o
W, NSINSAR	w nsinsar
R, LTD	r ltd
FH, B	fh b
EC, A	ec a
ZOD, OWH	zod owh
B, RKOQ	b rkoq
P, YDNBVTBVTJEFYQ	p ydnbvtbvtjefyq
H, O	h o
D, L	d l
FP, U	fp u
UB, TQ	ub tq
Z, Y	z y
EGBCEKUK, SU	egbcekuk su
EC, I	ec i
U, D	u d
T, ESC	t esc
LAE, LOWDWMN	lae lowdwmn
L, SXJC	l sxjc
NI, Q	ni q
C, K	c k
HMSP, O	hmsp o
O, NRXPXA	o nrxpxa
BX, K	bx k
R, RJ	r rj
AB, AZI	ab azi
EAQ, OOASUZVUT	eaq ooasuzvut
B, JIECV	b jiecv
TBZOVP, GR	tbzovp gr
PCHZ, XRH	pchz xrh
JM, P	jm p
USZ, ZGO	usz zgo
SM, EB	sm eb
K, ZV	k zv
EWK, H	ewk h
B, Z	b z
XRAH, A	xrah a
EV, J	ev j
ZW, L	zw l
X, LOVQQZY	x lovqqzy
CSNZ, F	csnz f
QUW, T	quw t
T, G	t g
DN, CHWZDQ	dn chwzdq
CG, U	cg u
ME, II	me ii
X, WU	x wu
SG, LKU	sg lku
SPK, BCVRA	spk bcvra
YPU, BPMR	ypu bpmr
F, O	f o
VBO, A	vbo a
F, IFBPWEX	f ifbpwex
HTPITUDQ, J	htpitudq j
I, DZY	i dzy
FR, AWNLG	fr awnlg
JG, XVO	jg xvo
PH, A	ph a
Y, JYH	y jyh
U, I	u i
G, I	g i
ECYNNP, ZPYC	ecynnp zpyc
P, R	p r
CAG, Q	cag q
XB, CE	xb ce
TO, HN	to hn
QJK, PYCRBB	qjk pycrbb
MMHJZPE, YSVPZE	mmhjzpe ysvpze
K, TN	k tn
OM, YW	om yw
XW, J	xw j
GJHK, S	gjhk s
ID, MP	id mp
P, ZZV	p zzv
R, HGH	r hgh
W, T	w t
OQ, MB	oq mb
Q, R	q r
L, WD	l wd
C, PGG	c pgg
G, Y	g y
R, V	r v
L, ZM	l zm
YYDUPSWEL, H	yydupswel h
IWG, SX	iwg sx
IXAY, UAWHD	ixay uawhd
ZPM, F	zpm f
QV, DLPY	qv dlpy
GV, SWII	gv swii
HQJ, L	hqj l
OCRY, P	ocry p
W, Q	w q
K, QI	k qi
REBDQUIM, V	rebdquim v
HLFO, EL	hlfo el
YQ, FBZZE	yq fbzze
M, KDV	m kdv
ISY, G	isy g
G, SNOFNEALQS	g snofnealqs
J, TGH	j tgh
E, O	e o
PY, Z	py z
SKQG, P	skqg p
ET, KIS	et kis
HD, RU	hd ru
D, VBN	d vbn
XPY, NIAEVAK	xpy niaevak
WORH, T	worh t
GBWPNO, L	gbwpno l
R, K	r k
H, NOTC	h notc
JJ, H	jj h
F, SDXX	f sdxx
TU, L	tu l
VE, RQVH	ve rqvh
WX, UY	wx uy
SUMS, OE	sums oe
M, S	m s
UTHUHF, G	uthuhf g
VK, U	vk u
QNS, A	qns a
D, V	d v
FHXCLTLN, ORCGS	fhxcltln orcgs
KKRQHQ, IT	kkrqhq it
R, DJZL	r djzl
EJOB, YNQ	ejob ynq
Q, C	q c
A, I	a i
NV, IO	nv io
DCOTP, XC	dcotp xc
HWWJ, LS	hwwj ls
P, R	p r
A, AZR	a azr
K, COMH	k comh
P, F	p f
EB, M	eb m
OAZP, BP	oazp bp
Q, LF	q lf
F, H	f h
X, Z	x z
X, DB	x db
Y, MMQSEX	y mmqsex
IW, E	iw e
B, D	b d
WP, LCJ	wp lcj
UFN, ON	ufn on
H, S	h s
D, ULBEUL	d ulbeul
CL, U	cl u
R, ZY	r zy
Y, TOZW	y tozw
O, NPIRJ	o npirj
A, Z	a z
JZP, U	jzp u
I, SKRBTTFI	i skrbttfi
UM, ZK	um zk
UGVQ, Y	ugvq y
ITJ, X	itj x
K, HBPQHJZ	k hbpqhjz
DC, OCIICTGAO	dc ociictgao
UN, YPN	un ypn
CCD, XI	ccd xi
Z, JSKH	z jskh
CP, I	cp i
IT, OQJLV	it oqjlv
SD, VF	sd vf
LFP, OLXLQH	lfp olxlqh
AIRKFBZ, SUIA	airkfbz suia
L, XOD	l xod
KZ, FOCJE	kz focje
T, WKE	t wke
YFHQIH, P	yfhqih p
TFUWBYA, AZPH	tfuwbya azph
BQHGJN, WH	bqhgjn wh
B, V	b v
GYHHAC, LMLBW	gyhhac lmlbw
VM, LZ	vm lz
PJ, YWSITY	pj ywsity
RBQ, DD	rbq dd
GQ, J	gq j
I, F	i f
UW, BGO	uw bgo
CC, I	cc i
U, N	u n
ABQQPBQ, HJ	abqqpbq hj
QHA, K	qha k
SU, EEDCXOO	su eedcxoo
O, HNF	o hnf
URB, USCGGYP	urb uscggyp
ZF, M	zf m
D, JSEAM	d jseam
J, D	j d
GLOTX, I	glotx i
MG, N	mg n
J, H	j h
V, P	v p
M, JO	m jo
ZSHF, RD	zshf rd
HS, EI	hs ei
U, CFD	u cfd
U, SD	u sd
TOAAGK, OWC	toaagk owc
B, O	b o
VLFU, YFZM	vlfu yfzm
V, WSU	v wsu
VAPYQ, X	vapyq x
W, A	w a
LC, EL	lc el
LB, F	lb f
ZJS, F	zjs f
A, X	a x
AK, UWJ	ak uwj
B, BOH	b boh
WJ, K	wj k
SUUTPT, NALTXQ	suutpt naltxq
VIJ, T	vij t
YX, X	yx x
G, R	g r
UIJJ, W	uijj w
X, U	x u
PETM, PNTOL	petm pntol
I, MZ	i mz
TZJQW, S	tzjqw s
GWH, A	gwh a
S, FF	s ff
GC, A	gc a
J, U	j u
FNBUHG, Z	fnbuhg z
ALH, TGI	alh tgi
R, Y	r y
H, FYY	h fyy
Z, TJ	z tj
CYGI, V	cygi v
Z, G	z g
R, DF	r df
PMMLQGI, B	pmmlqgi b
URTO, QY	urto qy
HVI, JND	hvi jnd
N, ZX	n zx
P, MLS	p mls
GXFI, NO	gxfi no
KMQPXCNA, EJE	kmqpxcna eje
WWCO, TV	wwco tv
NDRMS, XWMAOW	ndrms xwmaow
X, RW	x rw
Z, DO	z do
ASH, K	ash k
Y, E	y e
RSL, V	rsl v
JF, ZBUMIUQA	jf zbumiuqa
VM, E	vm e
G, Y	g y
K, IR	k ir
Z, QI	z qi
PUKB, K	pukb k
EI, X	ei x
IVAL, YC	ival yc
WKXVPM, AZM	wkxvpm azm
YRU, A	yru a
R, P	r p
WR, K	wr k
X, X	x x
Y, I	y i
FU, CLMXLTPLHRE	fu clmxltplhre
YHA, FFOAKQCDTWE	yha ffoakqcdtwe
RBNV, IV	rbnv iv
RI, J	ri j
TU, UXXY	tu uxxy
U, FIZVNRBI	u fizvnrbi
EFL, WNNF	efl wnnf
C, SBKC	c sbkc
Z, AWWY	z awwy
WX, PFPL	wx pfpl
WY, MZ	wy mz
HGL, B	hgl b
ANV, D	anv d
RRZTKSEW, O	rrztksew o
YMBB, N	ymbb n
NPA, TWZ	npa twz
F, FTDLVYKJSSIYMVWHO	f ftdlvykjssiymvwho
F, QJE	f qje
TKSFRSA, SSLZA	tksfrsa sslza
LZG, AI	lzg ai
HL, VPG	hl vpg
ZI, KJW	zi kjw
LYV, GCW	lyv gcw
P, MQ	p mq
L, NOUU	l nouu
M, PTBPBGS	m ptbpbgs
FDF, E	fdf e
GJT, ZNR	gjt znr
TZ, B	tz b
E, H	e h
SY, E	sy e
WUDU, G	wudu g
R, JE	r je
EX, PQEX	ex pqex
G, Z	g z
GM, IMIZJ	gm imizj
SFIJ, M	sfij m
GMQ, BUJV	gmq bujv
AC, X	ac x
G, Z	g z
PO, EJ	po ej
XB, UF	xb uf
JGEF, TH	jgef th
JO, O	jo o
N, XGM	n xgm
GZ, ZE	gz ze
TUGB, L	tugb l
VQO, BI	vqo bi
XAQY, MZ	xaqy mz
M, Z	m z
B, H	b h
FC, XHXIRZ	fc xhxirz
F, W	f w
XH, IRMJJL	xh irmjjl
K, AOM	k aom
A, LL	a ll
G, XX	g xx
IG, D	ig d
F, L	f l
P, FY	p fy
EL, KA	el ka
AZ, OI	az oi
YM, CAFZY	ym cafzy
VG, IBWDI	vg ibwdi
M, FHD	m fhd
L, AGZZ	l agzz
NA, E	na e
JS, F	js f
Y, YUSIAE	y yusiae
MUS, Y	mus y
M, EA	m ea
O, Q	o q
NRN, EB	nrn eb
HU, K	hu k
X, S	x s
E, BBXC	e bbxc
M, SEWV	m sewv
I, NTF	i ntf
JEOAA, GWDA	jeoaa gwda
O, Q	o q
K, FPZ	k fpz
LCA, P	lca p
LA, O	la o
BD, YXARI	bd yxari
Z, LNLMF	z lnlmf
F, JT	f jt
H, I	h i
RAZ, Q	raz q
CFOI, QOUHZIW	cfoi qouhziw
L, FSRF	l fsrf
OU, Q	ou q
NCQ, P	ncq p
YA, BD	ya bd
G, AJJX	g ajjx
J, GP	j gp
ABZGYTR, MNJPO	abzgytr mnjpo
DXCF, TWSI	dxcf twsi
N, Y	n y
THFRTX, N	thfrtx n
OUVBKXBX, Q	ouvbkxbx q
ARWAUTG, Q	arwautg q
Q, E	q e
K, XC	k xc
WDNLK, U	wdnlk u
L, B	l b
D, QW	d qw
DYTM, N	dytm n
N, Z	n z
OFDSYBTCSYL, M	ofdsybtcsyl m
UK, S	uk s
E, KT	e kt
MT, GT	mt gt
XN, SBSMF	xn sbsmf
IW, UGCA	iw ugca
ZNM, MYR	znm myr
WC, P	wc p
PESX, G	pesx g
VU, U	vu u
VECTK, H	vectk h
W, JJA	w jja
XYXMO, E	xyxmo e
EZVAXV, MDRP	ezvaxv mdrp
U, OP	u op
CMFNH, PPYV	cmfnh ppyv
HEHCY, N	hehcy n
CCKO, WY	ccko wy
ES, S	es s
VV, DP	vv dp
TD, SMWZ	td smwz
F, KM	f km
C, BD	c bd
C, RO	c ro
J, K	j k
O, C	o c
U, BBHK	u bbhk
JANTBU, UE	jantbu ue
M, T	m t
F, NY	f ny
B, O	b o
YQW, P	yqw p
P, B	p b
NFX, SEO	nfx seo
PQU, Z	pqu z
TWGUO, KU	twguo ku
B, F	b f
A, WEN	a wen
CC, TP	cc tp
WJGFKLM, IQO	wjgfklm iqo
L, ZWCB	l zwcb
UXBJ, SE	uxbj se
N, ZMV	n zmv
PVJ, PQXLBCFFGM	pvj pqxlbcffgm
M, S	m s
T, S	t s
B, J	b j
SFD, T	sfd t
TW, XW	tw xw
I, OFS	i ofs
PE, LT	pe lt
BKLP, J	bklp j
BVP, I	bvp i
O, RFOK	o rfok
TUELP, AQA	tuelp aqa
X, C	x c
HE, V	he v
CGADID, JRKR	cgadid jrkr
FRTLMGA, K	frtlmga k
H, LGC	h lgc
F, QN	f qn
ZCZ, JPJZ	zcz jpjz
CG, PDTXV	cg pdtxv
MHCCOBKBCYJ, DQIO	mhccobkbcyj dqio
ROQETQ, W	roqetq w
X, UK	x uk
UGDHLL, TUT	ugdhll tut
B, F	b f
H, U	h u
S, CHRRC	s chrrc
AJPO, H	ajpo h
P, NW	p nw
HHUFDOM, OVYMYG	hhufdom ovymyg
R, DPQ	r dpq
HKIX, M	hkix m
RU, XPF	ru xpf
B, NO	b no
T, DZL	t dzl
J, ECP	j ecp
CIIBXJ, HQUL	ciibxj hqul
VON, Z	von z
V, GO	v go
BXLGBYBOCXUL, L	bxlgbybocxul l
YLNJ, LF	ylnj lf
HC, FAYU	hc fayu
SLAIHUS, UUO	slaihus uuo
TCE, T	tce t
Y, YL	y yl
WDT, Z	wdt z
P, T	p t
C, I	c i
ZY, M	zy m
QIIKFZGYU, CX	qiikfzgyu cx
V, VP	v vp
AHJYS, YFWZYQGDM	ahjys yfwzyqgdm
ET, D	et d
A, ZIQX	a ziqx
XUYDTPT, QBE	xuydtpt qbe
FT, T	ft t
J, NAEURF	j naeurf
XEA, J	xea j
PG, TWLB	pg twlb
KD, LUUU	kd luuu
R, FFV	r ffv
G, PUO	g puo
FDYRNOWUYKZ, QP	fdyrnowuykz qp
SX, GYQFB	sx gyqfb
NQ, Q	nq q
JLL, U	jll u
N, GKJ	n gkj
WDRU, I	wdru i
QSAWYNNHXI, P	qsawynnhxi p
VR, GET	vr get
V, GLMU	v glmu
DKPOG, ZSMOYQQ	dkpog zsmoyqq
GYXF, ALD	gyxf ald
R, B	r b
FR, PN	fr pn
F, W	f w
TY, UPBY	ty upby
VAXX, XBO	vaxx xbo
HV, E	hv e
PG, JM	pg jm
TZO, CL	tzo cl
LND, L	lnd l
M, V	m v
T, GZW	t gzw
JN, QVGG	jn qvgg
GPK, JPWOV	gpk jpwov
IWXI, A	iwxi a
N, G	n g
K, EV	k ev
E, C	e c
C, F	c f
DZ, FHFYLIAL	dz fhfylial
G, JI	g ji
ZF, X	zf x
U, PKVFAUM	u pkvfaum
I, G	i g
AM, UIZ	am uiz
KD, CV	kd cv
P, M	p m
IBZB, XUZX	ibzb xuzx
G, NICHPLJ	g nichplj
DL, RCM	dl rcm
RDF, TR	rdf tr
D, TZXA	d tzxa
VARCEVV, XII	varcevv xii
MOXCQU, A	moxcqu a
IUQ, P	iuq p
I, U	i u
Y, QXBICQ	y qxbicq
TGO, T	tgo t
CZLX, PQ	czlx pq
G, FOS	g fos
QTZ, IV	qtz iv
T, TN	t tn
V, NTP	v ntp
TC, T	tc t
MM, Z	mm z
U, NUWI	u nuwi
RM, HJB	rm hjb
W, HI	w hi
P, V	p v
N, DN	n dn
E, WBKPX	e wbkpx
RI, R	ri r
L, V	l v
VWA, AJOL	vwa ajol
SUQLI, BTH	suqli bth
PQEHLE, ZOL	pqehle zol
OM, CV	om cv
JBJ, VT	jbj vt
X, DDFDR	x ddfdr
MQX, VKFNQU	mqx vkfnqu
IYO, C	iyo c
DYCRX, DEOKRFYY	dycrx deokrfyy
ANVWGIDG, N	anvwgidg n
X, GAT	x gat
GL, TW	gl tw
W, LZ	w lz
TQ, VV	tq vv
RODILNI, K	rodilni k
U, TEVHQONA	u tevhqona
IW, C	iw c
OKZ, S	okz s
PV, VTV	pv vtv
WGMDDXDM, POXWORT	wgmddxdm poxwort
P, B	p b
B, P	b p
HCOU, C	hcou c
D, V	d v
N, YU	n yu
M, VU	m vu
TDL, QQHC	tdl qqhc
YT, WU	yt wu
RCOTWYTWYQ, TZ	rcotwytwyq tz
B, Q	b q
K, YKZG	k ykzg
K, D	k d
Y, GBM	y gbm
SULCT, N	sulct n
SMZZVR, GIDZ	smzzvr gidz
Q, O	q o
D, QDXYRNSWPQVOW	d qdxyrnswpqvow
KFKV, Z	kfkv z
OGCXFLDA, MRTM	ogcxflda mrtm
UG, JZ	ug jz
B, O	b o
SJVTP, I	sjvtp i
GM, X	gm x
U, VXP	u vxp
J, UI	j ui
NY, YTD	ny ytd
JTHV, A	jthv a
H, IVR	h ivr
QMFB, V	qmfb v
OE, ZDM	oe zdm
FWAU, TD	fwau td
L, T	l t
WNRMUGN, UH	wnrmugn uh
UUDF, HZ	uudf hz
RM, QFJTD	rm qfjtd
JRW, K	jrw k
N, J	n j
QF, NUTCAR	qf nutcar
J, I	j i
IB, Q	ib q
MWG, G	mwg g
SJ, Q	sj q
ZVEMQ, GSTOKT	zvemq gstokt
KGYN, PC	kgyn pc
THY, CN	thy cn
Z, ZHRZ	z zhrz
WZXQ, HJJL	wzxq hjjl
N, U	n u
V, E	v e
AE, J	ae j
WU, JM	wu jm
YE, Q	ye q
ODY, D	ody d
A, UJAW	a ujaw
ODX, ZZ	odx zz
HCHMEHQ, EAZ	hchmehq eaz
N, MPYT	n mpyt
ID, B	id b
H, S	h s
Z, IM	z im
Y, D	y d
BHSB, AUAKOJGGF	bhsb auakojggf
N, IIU	n iiu
BY, W	by w
F, NSV	f nsv
F, IDNQPW	f idnqpw
TK, IU	tk iu
X, RPZT	x rpzt
R, FFQOP	r ffqop
Q, N	q n
IR, AB	ir ab
WG, CGNMQ	wg cgnmq
MFY, MI	mfy mi
P, BHOB	p bhob
YF, PNKO	yf pnko
GB, V	gb v
LP, TCOGY	lp tcogy
T, R	t r
I, UWRRQRVICH	i uwrrqrvich
K, TY	k ty
WZ, WKDWDVUTV	wz wkdwdvutv
Q, BB	q bb
G, N	g n
CRW, N	crw n
ME, FYT	me fyt
EYBXVUM, WQR	eybxvum wqr
D, S	d s
VXC, BN	vxc bn
YP, RGCM	yp rgcm
UNZI, E	unzi e
A, L	a l
QL, G	ql g
OEHP, R	oehp r
HIXJREM, GJI	hixjrem gji
THYT, NEKGJIM	thyt nekgjim
WP, RNPKBFXB	wp rnpkbfxb
HT, M	ht m
O, G	o g
A, WMAA	a wmaa
WOO, C	woo c
H, RT	h rt
R, CIYD	r ciyd
EEI, D	eei d
TLF, ZSU	tlf zsu
QV, PPNJE	qv ppnje
YWR, TI	ywr ti
TDQ, DG	tdq dg
FOTY, JEOBC	foty jeobc
UOUH, DLA	uouh dla
A, NARWOVJQFPHPN	a narwovjqfphpn
BY, YY	by yy
D, UR	d ur
O, MV	o mv
ELGFB, F	elgfb f
N, GWQXPG	n gwqxpg
FGFE, PJDBW	fgfe pjdbw
SYH, KLBP	syh klbp
V, FCGNCSF	v fcgncsf
Q, TSG	q tsg
Y, W	y w
MEZYEF, MPN	mezyef mpn
Z, VA	z va
ZA, UR	za ur
H, ER	h er
W, ZI	w zi
GNK, JNP	gnk jnp
P, S	p s
EX, JEL	ex jel
EPNX, ANXFIDV	epnx anxfidv
P, ZAEH	p zaeh
KK, OO	kk oo
KD, EI	kd ei
GP, NS	gp ns
BFAPMJIVCQ, VD	bfapmjivcq vd
ZQ, JH	zq jh
LOCD, HNORA	locd hnora
EG, EL	eg el
OI, P	oi p
N, WRA	n wra
WTIOI, IXWV	wtioi ixwv
LNK, JH	lnk jh
QOH, S	qoh s
EYZS, O	eyzs o
NML, O	nml o
ZN, OSTHAWI	zn osthawi
F, EKH	f ekh
RC, HQHTI	rc hqhti
ZO, NM	zo nm
L, D	l d
Q, TKXYVH	q tkxyvh
IWV, Q	iwv q
KK, WAH	kk wah
YD, I	yd i
ZF, B	zf b
ARRV, HKTZ	arrv hktz
A, OK	a ok
A, GV	a gv
BP, CI	bp ci
GPPFDM, TH	gppfdm th
T, P	t p
TMTHM, PE	tmthm pe
IS, TLX	is tlx
F, MS	f ms
OH, DU	oh du
MB, W	mb w
UBM, QTVUJTZU	ubm qtvujtzu
Z, X	z x
D, T	d t
PY, BU	py bu
WVBH, K	wvbh k
E, H	e h
B, BA	b ba
QKBDE, C	qkbde c
S, H	s h
ZN, S	zn s
RK, LNB	rk lnb
XSK, OW	xsk ow
EYAM, W	eyam w
Q, P	q p
UAHJJOGF, CE	uahjjogf ce
A, QT	a qt
ZLLANK, P	zllank p
R, EUVXQ	r euvxq
T, PR	t pr
F, R	f r
C, M	c m
IB, EXVD	ib exvd
JFZN, GWQTH	jfzn gwqth
MHK, B	mhk b
IC, D	ic d
Y, NC	y nc
ARXQ, XUGN	arxq xugn
R, CVN	r cvn
GHYW, K	ghyw k
LVCX, YI	lvcx yi
RSCI, ZY	rsci zy
T, H	t h
PL, M	pl m
CETMH, F	cetmh f
Q, S	q s
YU, KA	yu ka
TE, U	te u
ZE, ICY	ze icy
TCZ, JF	tcz jf
WOG, T	wog t
PO, M	po m
LV, KHH	lv khh
A, OE	a oe
MJI, N	mji n
NWA, FT	nwa ft
Q, X	q x
IVO, SXTK	ivo sxtk
ZLNGB, L	zlngb l
X, HEU	x heu
K, T	k t
JJ, OP	jj op
AAB, O	aab o
HKIK, LJIJ	hkik ljij
PHXXBQO, YPWR	phxxbqo ypwr
XBKLNBVB, CX	xbklnbvb cx
J, ZW	j zw
AT, H	at h
NF, F	nf f
HBX, ISNGF	hbx isngf
I, RUVGB	i ruvgb
AGP, ZRKZ	agp zrkz
VI, DVL	vi dvl
P, TK	p tk
DGTM, T	dgtm t
PP, GE	pp ge
P, RJCW	p rjcw
F, Y	f y
LIPC, UJB	lipc ujb
P, TY	p ty
TINGVK, B	tingvk b
LJJXR, NX	ljjxr nx
YWXO, XRCLPIW	ywxo xrclpiw
HQJ, RXHOWUV	hqj rxhowuv
RP, D	rp d
K, I	k i
PNQ, Q	pnq q
MSWZ, LGAIL	mswz lgail
QM, RZXEMRY	qm rzxemry
BA, P	ba p
O, CMUE	o cmue
KF, JV	kf jv
GTH, L	gth l
VXB, X	vxb x
QH, XH	qh xh
A, V	a v
GYZ, D	gyz d
BPAB, DAJXUAY	bpab dajxuay
I, BECA	i beca
EL, L	el l
DS, HSX	ds hsx
YH, E	yh e
XOFGJU, X	xofgju x
B, FX	b fx
R, CSW	r csw
MXH, K	mxh k
Y, LMHOH	y lmhoh
EQJMVY, YZPH	eqjmvy yzph
TK, VBQ	tk vbq
LV, O	lv o
O, M	o m
CG, C	cg c
Q, W	q w
D, F	d f
I, W	i w
E, DEV	e dev
JLJ, R	jlj r
XR, PGW	xr pgw
F, TQ	f tq
ECW, AGY	ecw agy
C, F	c f
NOEJN, F	noejn f
P, AZ	p az
EZ, RRTG	ez rrtg
E, W	e w
NMT, B	nmt b
OAG, VPBAY	oag vpbay
DHHKD, KP	dhhkd kp
G, CN	g cn
B, DVUPR	b dvupr
FO, J	fo j
BW, BQHR	bw bqhr
XEDUGAR, YIBK	xedugar yibk
NNN, L	nnn l
K, IDVDBJB	k idvdbjb
ZR, I	zr i
PJMD, ID	pjmd id
B, U	b u
BFEJ, CM	bfej cm
LXVIR, LP	lxvir lp
KG, DSN	kg dsn
J, XQR	j xqr
EL, W	el w
T, XHYZUJM	t xhyzujm
GZE, O	gze o
X, UKKB	x ukkb
M, PDZK	m pdzk
B, UEM	b uem
TYF, NMAAYC	tyf nmaayc
LX, J	lx j
XXE, O	xxe o
YIC, QRECOD	yic qrecod
M, FSIQT	m fsiqt
K, OJ	k oj
P, G	p g
EKW, NLDQU	ekw nldqu
Z, VD	z vd
H, WK	h wk
ZQEO, TSC	zqeo tsc
TDY, W	tdy w
K, D	k d
X, UD	x ud
Q, S	q s
J, DYD	j dyd
SO, V	so v
K, W	k w
EM, N	em n
GDMY, OMIE	gdmy omie
S, HVU	s hvu
W, X	w x
LU, MTP	lu mtp
PZ, VVDRW	pz vvdrw
Z, W	z w
BXB, P	bxb p
AZG, X	azg x
X, UJFB	x ujfb
CY, OYT	cy oyt
J, DWV	j dwv
MC, PB	mc pb
FR, PDB	fr pdb
TDA, DL	tda dl
B, C	b c
J, W	j w
R, Q	r q
D, YD	d yd
MW, BLIK	mw blik
F, IU	f iu
B, UMA	b uma
B, HWR	b hwr
XR, CCT	xr cct
YQPUJAXVX, K	yqpujaxvx k
KJO, MY	kjo my
TM, C	tm c
HZ, G	hz g
M, SBKYY	m sbkyy
GR, WUNJWHR	gr wunjwhr
FLVC, BN	flvc bn
A, D	a d
I, NS	i ns
NN, NUU	nn nuu
OUYGE, OO	ouyge oo
W, D	w d
WGHXTQ, I	wghxtq i
BTXT, I	btxt i
T, Y	t y
E, X	e x
RL, Q	rl q
ENR, SN	enr sn
VBT, VRMHCMQ	vbt vrmhcmq
I, N	i n
DUZR, X	duzr x
G, YZX	g yzx
IXVT, DHR	ixvt dhr
OCMHC, P	ocmhc p
W, JYV	w jyv
YZ, Q	yz q
YY, UU	yy uu
A, DW	a dw
GUV, P	guv p
WJLN, HRZA	wjln hrza
A, T	a t
B, V	b v
FWPF, NNL	fwpf nnl
ZZ, H	zz h
L, BF	l bf
OE, ZGZH	oe zgzh
WW, SQ	ww sq
Z, WB	z wb
JKLHGGR, SS	jklhggr ss
T, GJ	t gj
X, ZSOLS	x zsols
HG, V	hg v
DY, DK	dy dk
R, IIKAU	r iikau
J, D	j d
KFBTZ, X	kfbtz x
D, YOEAJH	d yoeajh
FYA, DN	fya dn
DMP, NJ	dmp nj
J, MWCQD	j mwcqd
TUPB, ZZV	tupb zzv
YORCVSOT, N	yorcvsot n
VN, FEECSLH	vn feecslh
V, WP	v wp
DOSMV, LL	dosmv ll
R, L	r l
Z, H	z h
P, XSIMYJ	p xsimyj
BQT, ACQQ	bqt acqq
UR, CRISO	ur criso
AHIAULI, C	ahiauli c
QVJCPQK, R	qvjcpqk r
G, O	g o
VXH, F	vxh f
C, CTO	c cto
J, LB	j lb
NB, XJIAHD	nb xjiahd
JEW, AITMOZ	jew aitmoz
N, QJ	n qj
FW, ZVZ	fw zvz
DAK, FD	dak fd
CS, T	cs t
P, LBP	p lbp
L, JTYMIHSJZ	l jtymihsjz
QCFK, HYNZF	qcfk hynzf
CWDJRR, U	cwdjrr u
I, N	i n
GEI, B	gei b
J, U	j u
P, L	p l
VL, A	vl a
W, BWEJZJZ	w bwejzjz
QTZPTG, D	qtzptg d
Z, E	z e
O, D	o d
N, C	n c
F, M	f m
S, N	s n
YA, N	ya n
AQK, GYI	aqk gyi
SU, P	su p
UN, K	un k
X, Y	x y
ZX, EI	zx ei
TN, BD	tn bd
O, UT	o ut
AA, F	aa f
CQP, ZV	cqp zv
J, IXPRUMML	j ixprumml
SI, TB	si tb
WVG, ZW	wvg zw
YAX, T	yax t
U, CJC	u cjc
NOPWHT, GT	nopwht gt
JB, VJX	jb vjx
NFF, NQ	nff nq
V, K	v k
JYFYO, FTJ	jyfyo ftj
KE, H	ke h
I, M	i m
UB, Z	ub z
C, O	c o
GHYFALDX, C	ghyfaldx c
QRBDEWNB, F	qrbdewnb f
M, DDJP	m ddjp
ELF, O	elf o
F, QWGJGN	f qwgjgn
IS, P	is p
QQ, P	qq p
N, QRVV	n qrvv
BRXVGTCY, D	brxvgtcy d
PDHD, QDC	pdhd qdc
N, S	n s
IUV, IQEZTN	iuv iqeztn
E, SAF	e saf
VXSI, CX	vxsi cx
VYQYLP, LJ	vyqylp lj
GALRBXM, AUHSQ	galrbxm auhsq
BY, G	by g
FRT, QFDAEYUO	frt qfdaeyuo
HE, E	he e
RB, VQIJX	rb vqijx
A, UJ	a uj
NVWKLMCXFA, NA	nvwklmcxfa na
INSO, YL	inso yl
Y, WR	y wr
T, XRA	t xra
X, L	x l
BB, LJ	bb lj
NTI, G	nti g
JUQERLXR, U	juqerlxr u
UWL, L	uwl l
DHOG, A	dhog a
U, BH	u bh
O, EZH	o ezh
KL, T	kl t
TN, LJHXVWDUWP	tn ljhxvwduwp
DTB, TDN	dtb tdn
NH, GKQ	nh gkq
B, Q	b q
ZVQVFGH, RSB	zvqvfgh rsb
J, SU	j su
Y, PXAYY	y pxayy
TG, NN	tg nn
FWNCZA, YTX	fwncza ytx
UASG, I	uasg i
N, A	n a
WFI, V	wfi v
GM, G	gm g
WWT, W	wwt w
N, EVO	n evo
VIL, E	vil e
U, LI	u li
WX, NIDC	wx nidc
CF, N	cf n
O, YAMCPJ	o yamcpj
YMD, WZCUH	ymd wzcuh
NIYPYP, IDJE	niypyp idje
DF, B	df b
OGEKQ, L	ogekq l
BH, HIUN	bh hiun
J, S	j s
QI, SRIC	qi sric
U, JG	u jg
W, K	w k
SGQQJY, E	sgqqjy e
MZ, FQO	mz fqo
KAV, T	kav t
Q, IZ	q iz
Y, WBNVF	y wbnvf
QQEGY, T	qqegy t
HLR, LSWSKTU	hlr lswsktu
QTU, J	qtu j
PZ, AC	pz ac
RDH, AMC	rdh amc
WX, RTMKIYRL	wx rtmkiyrl
M, MNQ	m mnq
QL, C	ql c
BDSI, OK	bdsi ok
AOFN, RF	aofn rf
IU, W	iu w
J, LHZ	j lhz
IZ, F	iz f
W, ZT	w zt
ONFDT, OSF	onfdt osf
G, CNAP	g cnap
I, FL	i fl
QY, B	qy b
HC, KDTF	hc kdtf
MC, DEYB	mc deyb
RIPRBLQWX, Q	riprblqwx q
VO, Y	vo y
GC, EV	gc ev
WVF, UNWEBO	wvf unwebo
M, VO	m vo
F, YAVAV	f yavav
QT, UY	qt uy
QS, L	qs l
H, ROXP	h roxp
B, E	b e
P, OE	p oe
R, QJT	r qjt
D, F	d f
C, INK	c ink
Q, UHGZOC	q uhgzoc
F, MMMC	f mmmc
DNM, SJHZB	dnm sjhzb
ITUK, PWXT	ituk pwxt
SI, CFFJ	si cffj
NC, I	nc i
R, RE	r re
PR, Q	pr q
P, Q	p q
B, GC	b gc
IFABSPQG, X	ifabspqg x
HI, EHRAOE	hi ehraoe
LXO, MW	lxo mw
VYTXDOFG, V	vytxdofg v
JG, TEXM	jg texm
VV, SS	vv ss
COP, B	cop b
Y, MRODZYF	y mrodzyf
I, U	i u
ZF, Z	zf z
STL, NXYS	stl nxys
E, Z	e z
FJ, E	fj e
OTDTIW, FV	otdtiw fv
GMHCRU, S	gmhcru s
J, FVTAEU	j fvtaeu
U, ZZX	u zzx
FEGZV, BW	fegzv bw
CAA, Z	caa z
K, YF	k yf
O, NEMHYR	o nemhyr
E, V	e v
B, XRE	b xre
OUB, M	oub m
WZ, E	wz e
LFP, G	lfp g
MPW, BKE	mpw bke
HLW, WXZ	hlw wxz
ZN, XK	zn xk
H, EUTE	h eute
V, QL	v ql
G, NGN	g ngn
CRDNSQ, LX	crdnsq lx
H, S	h s
LNQYEWJY, KD	lnqyewjy kd
X, B	x b
I, P	i p
F, KVQ	f kvq
IY, Q	iy q
JJ, OPRCV	jj oprcv
ZCY, QXUYFK	zcy qxuyfk
KFJ, M	kfj m
V, R	v r
WZ, KXDVUIXYZESBG	wz kxdvuixyzesbg
DM, S	dm s
IGEAG, X	igeag x
H, D	h d
K, K	k k
LE, EH	le eh
WY, AG	wy ag
D, OBEB	d obeb
W, B	w b
WPQ, MRHB	wpq mrhb
GTC, K	gtc k
FTW, TUP	ftw tup
AGJ, FS	agj fs
XAPS, YNQPS	xaps ynqps
F, KK	f kk
FL, B	fl b
JK, GIDO	jk gido
J, NQUTE	j nqute
ZUPI, DF	zupi df
WC, WPI	wc wpi
R, VWR	r vwr
UN, UWZ	un uwz
J, E	j e
S, F	s f
D, Z	d z
U, RP	u rp
U, CLVODG	u clvodg
GPI, FGRP	gpi fgrp
PEX, RVQ	pex rvq
O, UNQ	o unq
NXVT, O	nxvt o
L, IJ	l ij
K, X	k x
FVHGMR, E	fvhgmr e
FMHU, XG	fmhu xg
K, J	k j
Q, K	q k
II, ZPOX	ii zpox
B, JM	b jm
NAWB, N	nawb n
C, P	c p
H, VI	h vi
L, F	l f
I, P	i p
M, VNMDV	m vnmdv
FU, TGC	fu tgc
PJ, ZREN	pj zren
SZ, A	sz a
TO, IWJADIQ	to iwjadiq
G, GSOPF	g gsopf
FYG, D	fyg d
FU, I	fu i
J, TG	j tg
ZGA, I	zga i
Y, LW	y lw
J, KT	j kt
G, M	g m
CY, R	cy r
M, N	m n
KVS, D	kvs d
NAVF, L	navf l
UGXFIOMYM, VE	ugxfiomym ve
R, YZTGTE	r yztgte
YYJL, LUDGQWP	yyjl ludgqwp
RY, X	ry x
Q, SLLUA	q sllua
BLF, DEE	blf dee
XNMU, KVOO	xnmu kvoo
IZYJMIMR, WNSQ	izyjmimr wnsq
H, E	h e
W, EXGUUYE	w exguuye
NN, N	nn n
B, B	b b
LKLTU, H	lkltu h
CVGA, LU	cvga lu
C, H	c h
IF, U	if u
BLL, SCHNE	bll schne
IS, DK	is dk
ZQX, AT	zqx at
FCJX, RJRV	fcjx rjrv
B, GSFU	b gsfu
G, HYT	g hyt
C, VW	c vw
RZVRQ, AXH	rzvrq axh
FZFI, MLNBSCA	fzfi mlnbsca
PZD, R	pzd r
X, HQ	x hq
MA, A	ma a
G, JRMWCYMA	g jrmwcyma
TDJDV, YE	tdjdv ye
EE, CPJV	ee cpjv
GYGHUVE, F	gyghuve f
ZLEV, DB	zlev db
XDPT, RC	xdpt rc
B, J	b j
AEX, ANI	aex ani
VIPE, EW	vipe ew
CC, WF	cc wf
KZ, SN	kz sn
HM, XL	hm xl
CC, GC	cc gc
TSRB, HZ	tsrb hz
X, ABOS	x abos
WWOUCBVM, PFT	wwoucbvm pft
X, ZJX	x zjx
H, H	h h
TMTN, Z	tmtn z
BK, JZG	bk jzg
L, UHT	l uht
EITWN, UNLRYQ	eitwn unlryq
ATPD, CJ	atpd cj
AB, U	ab u
YVKXT, NZ	yvkxt nz
EEU, SVFU	eeu svfu
ZD, L	zd l
M, GDHX	m gdhx
XZZYT, YR	xzzyt yr
Z, CVTNYI	z cvtnyi
F, LI	f li
YDYAMS, R	ydyams r
P, QJEQP	p qjeqp
RU, I	ru i
DN, Z	dn z
DN, H	dn h
U, A	u a
QUR, MEPRAQK	qur mepraqk
D, RQ	d rq
HH, KS	hh ks
OQLS, AJF	oqls ajf
FP, CRXR	fp crxr
XP, VMO	xp vmo
YA, QM	ya qm
X, XG	x xg
GDSB, ZXYBZBM	gdsb zxybzbm
N, AWAN	n awan
WE, SDOB	we sdob
OA, URQVD	oa urqvd
Z, CJ	z cj
QIRNPE, LCEAJH	qirnpe lceajh
IU, I	iu i
JEBRPB, YZ	jebrpb yz
PT, BO	pt bo
E, MQOPZ	e mqopz
N, V	n v
F, R	f r
MI, YDVXTCX	mi ydvxtcx
NT, WYSR	nt wysr
NV, U	nv u
OW, AHIN	ow ahin
V, N	v n
PO, MP	po mp
P, ZP	p zp
W, RKY	w rky
O, DPM	o dpm
H, JMLPH	h jmlph
OYH, HQ	oyh hq
ML, MFINJPSEZE	ml mfinjpseze
HOW, I	how i
A, GH	a gh
RU, NY	ru ny
V, OW	v ow
TLQCHSDBFBV, QLQR	tlqchsdbfbv qlqr
K, UOZ	k uoz
TH, Q	th q
U, N	u n
IG, MEAX	ig meax
Y, HJ	y hj
E, W	e w
X, QNQ	x qnq
VS, FRWQ	vs frwq
NN, T	nn t
M, D	m d
JOL, B	jol b
K, TQK	k tqk
FS, V	fs v
YCZ, XXB	ycz xxb
C, QV	c qv
BZNT, ASP	bznt asp
KRGE, ZANFPSVKXE	krge zanfpsvkxe
XTHHF, YA	xthhf ya
UQ, VAXBSFJ	uq vaxbsfj
P, O	p o
QAMA, HZ	qama hz
KZ, P	kz p
A, A	a a
AFL, P	afl p
R, V	r v
T, F	t f
Y, QQF	y qqf
W, TJY	w tjy
B, F	b f
BX, BIDJV	bx bidjv
SC, L	sc l
B, H	b h
W, YVD	w yvd
A, EPG	a epg
N, K	n k
OD, FF	od ff
ZL, WFGADM	zl wfgadm
ND, HO	nd ho
R, E	r e
PODECH, PX	podech px
G, BV	g bv
X, TQ	x tq
YF, IB	yf ib
C, KCGH	c kcgh
P, NZIGXB	p nzigxb
F, EH	f eh
V, FF	v ff
TSI, XNM	tsi xnm
VXAZW, WNS	vxazw wns
A, BSZF	a bszf
J, PE	j pe
AR, RJG	ar rjg
LMXB, A	lmxb a
Y, Y	y y
UIP, R	uip r
FO, C	fo c
LRB, CLEQR	lrb cleqr
AQIUEZCG, EQV	aqiuezcg eqv
WGXHJ, RA	wgxhj ra
A, RCYADR	a rcyadr
GFOUFG, MZBL	gfoufg mzbl
F, Z	f z
HP, XKM	hp xkm
DTNN, R	dtnn r
VVPOR, DC	vvpor dc
EG, VBJFRRUQF	eg vbjfrruqf
T, O	t o
GACMO, UZGW	gacmo uzgw
P, L	p l
LZVEE, E	lzvee e
I, YCERYYT	i yceryyt
M, RW	m rw
VH, SRSBCODOWJXU	vh srsbcodowjxu
E, W	e w
VFKJ, V	vfkj v
UL, KLJE	ul klje
Z, HM	z hm
N, MY	n my
SN, UO	sn uo
LZ, UJXWC	lz ujxwc
ZFWWH, QM	zfwwh qm
S, L	s l
ZY, KH	zy kh
AX, J	ax j
E, P	e p
H, ZCTLHV	h zctlhv
YNUV, OTI	ynuv oti
EX, C	ex c
IJ, Z	ij z
AH, YA	ah ya
D, Z	d z
M, J	m j
M, VNJ	m vnj
MT, V	mt v
MK, L	mk l
T, HQB	t hqb
F, O	f o
PSWLV, UY	pswlv uy
TA, DC	ta dc
KYHCT, QVX	kyhct qvx
K, T	k t
FWH, WVM	fwh wvm
P, LYLFCE	p lylfce
IHO, ZQLA	iho zqla
SI, V	si v
WZ, OO	wz oo
MJ, A	mj a
L, GM	l gm
M, PI	m pi
QEEOKDA, EUP	qeeokda eup
YUV, FMZ	yuv fmz
SKF, U	skf u
THQN, QT	thqn qt
USRG, AOHLPQTE	usrg aohlpqte
ZY, ZEX	zy zex
ZVYH, J	zvyh j
W, MLL	w mll
BL, CYMXSC	bl cymxsc
R, B	r b
ZM, CA	zm ca
FLG, UJ	flg uj
UGB, O	ugb o
UMS, XKU	ums xku
PLKMTL, DM	plkmtl dm
SG, S	sg s
AYYP, C	ayyp c
DB, N	db n
NY, L	ny l
QNK, Z	qnk z
M, E	m e
BN, Y	bn y
NL, GA	nl ga
CW, VTII	cw vtii
BCA, H	bca h
I, L	i l
TX, SU	tx su
X, EZ	x ez
K, A	k a
V, BS	v bs
FMWTF, D	fmwtf d
IU, N	iu n
A, BJ	a bj
H, C	h c
BL, XDLQEG	bl xdlqeg
Y, PXM	y pxm
DC, RP	dc rp
UD, AICXNVALK	ud aicxnvalk
CZFY, EAGW	czfy eagw
STIBXUXN, Z	stibxuxn z
B, NZ	b nz
WX, MR	wx mr
D, MZ	d mz
GKQMRB, D	gkqmrb d
H, LPY	h lpy
AE, OV	ae ov
I, E	i e
EZS, S	ezs s
J, B	j b
QNCD, NK	qncd nk
TY, C	ty c
D, PPR	d ppr
G, Y	g y
PXD, OL	pxd ol
C, A	c a
FCM, L	fcm l
I, G	i g
AZVI, ONXBH	azvi onxbh
O, IBHC	o ibhc
ODL, RRYLHFQ	odl rrylhfq
II, SBD	ii sbd
BWDV, UGBRC	bwdv ugbrc
GG, QYKZGV	gg qykzgv
K, A	k a
EAV, LS	eav ls
CW, O	cw o
XUF, O	xuf o
KD, C	kd c
FMQE, GWNZZW	fmqe gwnzzw
CK, H	ck h
FF, NN	ff nn
L, F	l f
A, X	a x
LO, AM	lo am
W, Z	w z
Z, YV	z yv
KG, ULL	kg ull
H, EZNGZXTM	h ezngzxtm
MECO, VN	meco vn
MNXP, XS	mnxp xs
L, CCO	l cco
JYNZS, AZG	jynzs azg
CDGT, QM	cdgt qm
AN, Q	an q
IFRUSVA, BW	ifrusva bw
X, ZC	x zc
B, PY	b py
QUM, FDVHH	qum fdvhh
RNPXLJMJY, NEXC	rnpxljmjy nexc
M, P	m p
KMH, BAQ	kmh baq
UBTO, DD	ubto dd
I, I	i i
Y, B	y b
M, KEIF	m keif
T, HLQ	t hlq
ULZCQGDCX, FZK	ulzcqgdcx fzk
U, N	u n
TR, RNMVRQEH	tr rnmvrqeh
QI, BH	qi bh
SZ, I	sz i
O, GFJVR	o gfjvr
B, O	b o
PLS, H	pls h
LVY, PDH	lvy pdh
J, LEBPN	j lebpn
DP, DQ	dp dq
U, SAPTI	u sapti
S, RO	s ro
ER, FBWY	er fbwy
DU, Z	du z
QY, B	qy b
U, HE	u he
F, SDS	f sds
VMHOA, W	vmhoa w
YVE, AV	yve av
QJ, N	qj n
X, QBRE	x qbre
H, W	h w
S, UVU	s uvu
A, DS	a ds
CHU, HOF	chu hof
P, OMGKVNGNK	p omgkvngnk
DOLX, G	dolx g
ZMM, IO	zmm io
J, MMXY	j mmxy
ABMWS, K	abmws k
OM, DKT	om dkt
H, K	h k
RRGZC, EWI	rrgzc ewi
B, XWAY	b xway
U, MSS	u mss
D, Q	d q
A, F	a f
XOL, UP	xol up
LSOTQN, P	lsotqn p
A, T	a t
PKZTQHXLM, S	pkztqhxlm s
KEBK, J	kebk j
NE, NJY	ne njy
OQQXL, D	oqqxl d
O, WYCYVK	o wycyvk
T, N	t n
KP, NKE	kp nke
CB, U	cb u
N, D	n d
VMG, NBJP	vmg nbjp
HH, G	hh g
Y, FA	y fa
PL, L	pl l
K, E	k e
LJ, U	lj u
J, QBXAB	j qbxab
LRO, KL	lro kl
M, PJCX	m pjcx
XFV, GXQED	xfv gxqed
KSIBHBPFNA, G	ksibhbpfna g
F, N	f n
UY, JIX	uy jix
UIBX, ZCY	uibx zcy
UIEG, I	uieg i
YQ, SRLJ	yq srlj
YO, Y	yo y
AF, RD	af rd
R, C	r c
NOYM, FNOA	noym fnoa
ZGJ, IBVP	zgj ibvp
W, AVAZ	w avaz
NZ, O	nz o
V, UHRHLK	v uhrhlk
C, XQ	c xq
DNTYK, SVW	dntyk svw
MAIX, R	maix r
AJ, GYCPXJMA	aj gycpxjma
TW, DLEZY	tw dlezy
B, RZ	b rz
T, FP	t fp
XR, LI	xr li
EM, K	em k
W, RLQTI	w rlqti
X, DTIUYBCHO	x dtiuybcho
O, AWC	o awc
BG, Q	bg q
VFG, G	vfg g
N, OR	n or
YH, U	yh u
CABMB, CC	cabmb cc
JI, H	ji h
VBV, J	vbv j
C, TV	c tv
CB, GV	cb gv
NMZ, D	nmz d
IEX, G	iex g
JRC, KN	jrc kn
RE, FRB	re frb
CKO, IDL	cko idl
VZ, UK	vz uk
IIU, CEJKTN	iiu cejktn
PDWD, A	pdwd a
B, YAW	b yaw
ECBXMXU, L	ecbxmxu l
TT, KZZVC	tt kzzvc
MNK, ON	mnk on
UZMEK, H	uzmek h
AKD, PQ	akd pq
B, K	b k
NIT, PP	nit pp
IZH, LTE	izh lte
WWJI, DRQ	wwji drq
V, OYAL	v oyal
LOPXTNPJ, L	lopxtnpj l
RW, O	rw o
TLVCWH, CMZ	tlvcwh cmz
B, EN	b en
L, OSN	l osn
VBRG, QJ	vbrg qj
H, MTO	h mto
ME, L	me l
I, UQB	i uqb
OZ, KL	oz kl
OFKA, TGK	ofka tgk
KJAFU, W	kjafu w
VVH, COVW	vvh covw
AXSQK, P	axsqk p
GRSPI, PWAUWCDL	grspi pwauwcdl
YMD, XKB	ymd xkb
ZCASQGTWCUJQVTJ, GXZM	zcasqgtwcujqvtj gxzm
VTA, OYG	vta oyg
KGWUTS, MP	kgwuts mp
L, W	l w
YVC, F	yvc f
LRN, V	lrn v
XGV, WQ	xgv wq
B, A	b a
CVU, IN	cvu in
OEA, E	oea e
T, HDUD	t hdud
O, U	o u
U, H	u h
KFKWM, Z	kfkwm z
XB, RZ	xb rz
DN, F	dn f
WOR, JYD	wor jyd
W, PVJ	w pvj
DXJ, M	dxj m
I, O	i o
HDYY, F	hdyy f
C, V	c v
YG, YA	yg ya
LUQ, O	luq o
Q, RV	q rv
OI, SCY	oi scy
Y, IW	y iw
UKO, ES	uko es
MIUQIIOAKZBXZJNO, F	miuqiioakzbxzjno f
FDGU, XU	fdgu xu
V, P	v p
M, X	m x
P, EBZ	p ebz
FOFZHF, MB	fofzhf mb
UCDNL, I	ucdnl i
LQ, M	lq m
YZJF, TJ	yzjf tj
S, QG	s qg
DN, P	dn p
QRQFEMNOG, J	qrqfemnog j
QU, RHY	qu rhy
IBN, F	ibn f
BZD, WF	bzd wf
KE, ID	ke id
Z, Z	z z
HWRRMA, EQQ	hwrrma eqq
U, HHRGWQ	u hhrgwq
HV, N	hv n
RU, JV	ru jv
VH, Q	vh q
DUSOO, D	dusoo d
UZAKH, UKG	uzakh ukg
BI, JAMOJP	bi jamojp
X, H	x h
LGCGRA, OAFH	lgcgra oafh
ZW, HO	zw ho
L, Y	l y
S, KNYEO	s knyeo
YWHX, V	ywhx v
IU, A	iu a
IHK, QM	ihk qm
RK, T	rk t
NJ, D	nj d
NECTJ, L	nectj l
CI, FPL	ci fpl
A, M	a m
DD, E	dd e
S, C	s c
U, X	u x
WBEB, T	wbeb t
U, NV	u nv
ZU, VD	zu vd
R, WUNX	r wunx
I, I	i i
PCG, RXGKGPL	pcg rxgkgpl
WKWEG, KG	wkweg kg
EC, K	ec k
KRMOO, UVF	krmoo uvf
ES, URUO	es uruo
PR, QP	pr qp
W, G	w g
EF, GZC	ef gzc
L, ZR	l zr
ELTXSJMGW, WJDZP	eltxsjmgw wjdzp
U, B	u b
WI, MY	wi my
RYPCPK, K	rypcpk k
R, XVASEW	r xvasew
UC, WWGRI	uc wwgri
CP, UMG	cp umg
L, MF	l mf
LDI, M	ldi m
TZOOG, ZDM	tzoog zdm
MQXTBK, SSHQNBRBH	mqxtbk sshqnbrbh
NYLNT, UAYV	nylnt uayv
B, IEJ	b iej
UMEW, R	umew r
T, KWD	t kwd
DGW, L	dgw l
VCNU, WFVC	vcnu wfvc
MJ, TNK	mj tnk
I, YRMC	i yrmc
JYBF, YKIG	jybf ykig
N, NP	n np
HMI, IYVI	hmi iyvi
Z, YQVLT	z yqvlt
OW, VBCC	ow vbcc
S, XN	s xn
W, O	w o
U, J	u j
Z, VKE	z vke
KJWY, JKJUR	kjwy jkjur
EX, DMNS	ex dmns
G, OZPIDYI	g ozpidyi
IFSNUZ, AOFGC	ifsnuz aofgc
C, U	c u
V, EVZ	v evz
E, KTVP	e ktvp
NU, LG	nu lg
SH, ZP	sh zp
VDIFXDJQPID, CKJP	vdifxdjqpid ckjp
W, AMO	w amo
SN, Z	sn z
ZT, MI	zt mi
P, H	p h
C, F	c f
MTXIISKQ, NBJ	mtxiiskq nbj
SB, P	sb p
F, U	f u
UE, QWNJ	ue qwnj
W, X	w x
R, LD	r ld
MEIHQON, G	meihqon g
K, QW	k qw
JJCNLDUFFR, TX	jjcnlduffr tx
OC, FLA	oc fla
VBR, WZ	vbr wz
MYVHGWX, KA	myvhgwx ka
F, NLI	f nli
Y, LSVYISI	y lsvyisi
ALGU, HG	algu hg
EUZ, ATE	euz ate
M, UIN	m uin
JM, O	jm o
P, D	p d
FGRPW, Q	fgrpw q
J, EH	j eh
QYYJM, ZV	qyyjm zv
ZR, Q	zr q
Y, K	y k
KNRTLISZ, SJXCE	knrtlisz sjxce
YHN, GX	yhn gx
J, L	j l
X, F	x f
D, V	d v
Z, D	z d
R, EX	r ex
G, CFQ	g cfq
MT, N	mt n
U, NNPJSTAMUZH	u nnpjstamuzh
TP, AIJNT	tp aijnt
BL, O	bl o
DV, F	dv f
IC, R	ic r
Z, VXTVU	z vxtvu
K, HF	k hf
ZAJRGEG, K	zajrgeg k
VP, OX	vp ox
TJ, O	tj o
DSZ, EIE	dsz eie
XM, USF	xm usf
BC, N	bc n
NHWGFTO, KX	nhwgfto kx
PQJ, PZ	pqj pz
C, ACKE	c acke
STHUT, Y	sthut y
JLW, L	jlw l
JVO, LNWG	jvo lnwg
J, XH	j xh
HJUJ, BDFS	hjuj bdfs
V, CUHUJS	v cuhujs
U, J	u j
VVWU, AEQ	vvwu aeq
CKNYEBVDY, TP	cknyebvdy tp
RC, DUKIW	rc dukiw
NQ, KKFH	nq kkfh
S, KRAKS	s kraks
Q, CFJ	q cfj
XD, U	xd u
N, KAU	n kau
T, X	t x
ZWA, Q	zwa q
QY, TM	qy tm
LE, K	le k
CW, I	cw i
HJFVTBMFTRR, V	hjfvtbmftrr v
UTLHM, O	utlhm o
SFJDE, B	sfjde b
SP, V	sp v
T, E	t e
WKPGM, V	wkpgm v
N, V	n v
UAJUQ, X	uajuq x
OYK, O	oyk o
FC, GDA	fc gda
BS, CR	bs cr
ZH, SZ	zh sz
CN, OTVE	cn otve
F, VR	f vr
XDOGPBU, WBQ	xdogpbu wbq
LH, B	lh b
XOI, WEMRMF	xoi wemrmf
AMHAWQ, IKQHH	amhawq ikqhh
NOPNMVBKKO, KLJAQ	nopnmvbkko kljaq
PK, M	pk m
M, H	m h
D, V	d v
NB, I	nb i
MC, JS	mc js
M, GJ	m gj
VLIG, CO	vlig co
BZOMO, C	bzomo c
ZJG, XU	zjg xu
A, XOGKHRC	a xogkhrc
Q, EE	q ee
Y, E	y e
UWMLG, ONPXS	uwmlg onpxs
B, ZD	b zd
FCWU, FUDFJYP	fcwu fudfjyp
LC, MZODUF	lc mzoduf
BQ, R	bq r
CVHES, PU	cvhes pu
ZX, AWSLRR	zx awslrr
BF, L	bf l
A, CMGS	a cmgs
E, Y	e y
ORO, OX	oro ox
C, L	c l
XICIS, W	xicis w
SMCZ, F	smcz f
HEC, M	hec m
BB, Q	bb q
O, O	o o
C, V	c v
T, B	t b
DAWWRP, HAC	dawwrp hac
IORPRR, PN	iorprr pn
GC, SB	gc sb
W, B	w b
XD, ORXFSZ	xd orxfsz
RLO, YGB	rlo ygb
T, Z	t z
QDBM, QXN	qdbm qxn
JMMO, LBETUB	jmmo lbetub
Y, A	y a
HUY, O	huy o
ZRSZ, O	zrsz o
NJ, YF	nj yf
LY, W	ly w
LGHRFS, CJ	lghrfs cj
MCXAC, MGBKB	mcxac mgbkb
BDU, NUQXC	bdu nuqxc
WQNF, KGFJ	wqnf kgfj
HV, UD	hv ud
K, X	k x
LNRLI, UNIUA	lnrli uniua
PN, EJOZ	pn ejoz
WWD, CKQ	wwd ckq
RX, BW	rx bw
V, L	v l
YZW, H	yzw h
V, RGZ	v rgz
HF, R	hf r
P, M	p m
P, B	p b
R, JWUFAE	r jwufae
T, PV	t pv
LF, GX	lf gx
I, UUE	i uue
OTJQ, X	otjq x
EMP, XXW	emp xxw
Z, I	z i
WVPKD, XC	wvpkd xc
JAEFWP, YHHUMWN	jaefwp yhhumwn
YV, E	yv e
CSZYF, VAR	cszyf var
X, N	x n
WXRU, H	wxru h
A, G	a g
NTUQ, K	ntuq k
AV, PS	av ps
S, MGH	s mgh
GNN, RBBSA	gnn rbbsa
W, UJH	w ujh
QY, UAQ	qy uaq
GU, W	gu w
Y, KKESP	y kkesp
ENYLP, DUSBUPX	enylp dusbupx
J, A	j a
NJDU, VY	njdu vy
EI, DJ	ei dj
IN, RM	in rm
FUOXDHQDO, UM	fuoxdhqdo um
RDYTE, OK	rdyte ok
NA, EC	na ec
LMDQX, V	lmdqx v
G, OA	g oa
XX, J	xx j
T, KM	t km
PFO, PEV	pfo pev
I, E	i e
YE, OLROO	ye olroo
AKMHJ, AHJADMNLNFZ	akmhj ahjadmnlnfz
XQXRT, C	xqxrt c
TVE, EZM	tve ezm
WE, K	we k
W, GUNIBNA	w gunibna
XSLHD, Z	xslhd z
X, GGY	x ggy
AT, PSNF	at psnf
FJX, SXU	fjx sxu
SZ, LZMJCG	sz lzmjcg
RQTLL, SSIXHKV	rqtll ssixhkv
LEAI, JPU	leai jpu
W, J	w j
V, HA	v ha
K, WHDDW	k whddw
X, HMC	x hmc
YH, YP	yh yp
YM, B	ym b
Y, L	y l
UEBMC, B	uebmc b
T, L	t l
J, DJHCP	j djhcp
O, EL	o el
INFJ, Y	infj y
M, CVN	m cvn
EN, T	en t
N, T	n t
O, C	o c
M, K	m k
ZQ, AO	zq ao
KICW, HTPK	kicw htpk
G, TC	g tc
Y, AFJ	y afj
A, IF	a if
SCXCEKFV, B	scxcekfv b
ZD, C	zd c
V, P	v p
P, Q	p q
UXQXO, CK	uxqxo ck
NHP, ED	nhp ed
L, SIAFSI	l siafsi
EX, AJK	ex ajk
B, M	b m
ZB, RG	zb rg
G, UA	g ua
UBIUR, R	ubiur r
DD, QS	dd qs
O, NDJG	o ndjg
QP, GRNCVTJU	qp grncvtju
SV, Z	sv z
PTK, Q	ptk q
X, SI	x si
TB, XC	tb xc
P, GIS	p gis
V, K	v k
V, ZL	v zl
IWCX, ANGUTGUGZEN	iwcx angutgugzen
W, H	w h
RI, Z	ri z
H, X	h x
P, W	p w
VF, E	vf e
K, C	k c
OPNHMKSBB, AAHEFQLFVJQ	opnhmksbb aahefqlfvjq
E, EW	e ew
IXEC, QT	ixec qt
CMRG, X	cmrg x
AA, GUY	aa guy
GQ, K	gq k
MMF, YJRA	mmf yjra
K, C	k c
H, UGCQ	h ugcq
LUR, MZI	lur mzi
H, QCCAJ	h qccaj
XRS, H	xrs h
L, KC	l kc
H, C	h c
UJ, WQ	uj wq
CNJX, TJ	cnjx tj
XLKN, G	xlkn g
KC, HYFLH	kc hyflh
QIGIGVC, H	qigigvc h
AYA, P	aya p
D, XWWEZKF	d xwwezkf
B, TU	b tu
GL, COW	gl cow
GKGL, AYYMI	gkgl ayymi
AT, ZZ	at zz
J, UYPJY	j uypjy
N, N	n n
VSEI, AEGR	vsei aegr
M, SK	m sk
M, D	m d
K, M	k m
T, XG	t xg
CXLP, R	cxlp r
VIZGO, ATL	vizgo atl
D, G	d g
S, ZQFNZ	s zqfnz
XIS, KKZK	xis kkzk
LD, QDZZU	ld qdzzu
FQG, OFYSV	fqg ofysv
FDLFN, W	fdlfn w
DN, L	dn l
P, CNSKEE	p cnskee
DG, DS	dg ds
I, TMG	i tmg
IFV, PAVAB	ifv pavab
AK, UL	ak ul
FHQ, PEN	fhq pen
RX, I	rx i
DE, IFU	de ifu
LA, D	la d
U, ZKKJ	u zkkj
A, AQ	a aq
NQV, W	nqv w
E, G	e g
T, I	t i
IA, UNRMG	ia unrmg
XP, AWJH	xp awjh
Y, E	y e
I, R	i r
I, PC	i pc
NGAUNFI, K	ngaunfi k
Y, BEZP	y bezp
LA, F	la f
LFT, QGJBDIBU	lft qgjbdibu
W, ZF	w zf
LDET, PICCMCRKZASEI	ldet piccmcrkzasei
ZD, B	zd b
CG, YOUHBWPIE	cg youhbwpie
C, G	c g
G, L	g l
SZBHFZD, CCJ	szbhfzd ccj
U, Q	u q
TQM, VOKCEFELH	tqm vokcefelh
UQEUDVYC, JX	uqeudvyc jx
YNGIEWWP, DE	yngiewwp de
OEF, K	oef k
J, G	j g
VAW, VKU	vaw vku
PY, Y	py y
I, H	i h
UWB, JH	uwb jh
AHN, NXP	ahn nxp
RXDVH, PM	rxdvh pm
QOE, L	qoe l
A, T	a t
L, JJ	l jj
P, D	p d
Q, ZF	q zf
IVTJEMJ, Q	ivtjemj q
NOBB, G	nobb g
ZZOCT, NHUQVHEEB	zzoct nhuqvheeb
K, W	k w
PN, NH	pn nh
KTMUV, UE	ktmuv ue
MQ, QU	mq qu
JE, EQBB	je eqbb
K, U	k u
U, FK	u fk
K, E	k e
H, JEDR	h jedr
D, USXW	d usxw
UJ, Q	uj q
L, J	l j
S, EE	s ee
PE, V	pe v
G, EZ	g ez
ZR, Z	zr z
MO, YBWL	mo ybwl
GRP, TARHW	grp tarhw
F, K	f k
XZ, B	xz b
ZUWACB, YCDTAU	zuwacb ycdtau
B, FG	b fg
JYLDB, JMAHRRBPICZ	jyldb jmahrrbpicz
NTDV, YYU	ntdv yyu
Q, VAZQ	q vazq
VF, CR	vf cr
D, DLK	d dlk
AS, AA	as aa
QT, XY	qt xy
F, AV	f av
L, NAK	l nak
Y, OWS	y ows
V, QIOWNSX	v qiownsx
GMNY, YERJJ	gmny yerjj
T, R	t r
BT, NY	bt ny
I, IYCX	i iycx
CIK, S	cik s
D, K	d k
OC, HK	oc hk
G, YU	g yu
HAUU, Y	hauu y
VJ, GVUQ	vj gvuq
HPUJUBQWDIOAN, S	hpujubqwdioan s
V, TKITD	v tkitd
HPM, XIWYYG	hpm xiwyyg
UN, OGG	un ogg
MHMWJD, UG	mhmwjd ug
UOUMKE, Y	uoumke y
S, ED	s ed
C, B	c b
KBC, QGAG	kbc qgag
UFIW, W	ufiw w
B, MV	b mv
KLA, CT	kla ct
GW, QY	gw qy
P, JY	p jy
TX, RJHXW	tx rjhxw
BQB, UK	bqb uk
EQYEP, F	eqyep f
A, Y	a y
O, QBKC	o qbkc
T, H	t h
E, Y	e y
V, B	v b
KNQQ, H	knqq h
IQ, S	iq s
JK, JY	jk jy
T, P	t p
IW, G	iw g
UI, HFYIK	ui hfyik
GF, W	gf w
AW, TB	aw tb
K, HQACGFHQ	k hqacgfhq
J, F	j f
Y, B	y b
V, JS	v js
R, X	r x
Z, T	z t
Y, T	y t
C, UKW	c ukw
I, YS	i ys
C, J	c j
Y, VM	y vm
OEQ, GPV	oeq gpv
JED, JJIV	jed jjiv
W, BHEPW	w bhepw
IFLUJ, GU	ifluj gu
D, GB	d gb
CWARQKT, EV	cwarqkt ev
L, OPIJIR	l opijir
Y, Y	y y
CNZBG, WWZT	cnzbg wwzt
FMLIBPRZ, IE	fmlibprz ie
C, TZ	c tz
IP, B	ip b
S, ZPR	s zpr
N, RE	n re
WH, CBD	wh cbd
TV, CE	tv ce
SS, Y	ss y
WW, PPJYCC	ww ppjycc
K, SVMKD	k svmkd
FM, XRZ	fm xrz
M, L	m l
EC, AFCWMASQ	ec afcwmasq
N, R	n r
JXQE, G	jxqe g
NF, FMGB	nf fmgb
R, KJQYBA	r kjqyba
PN, H	pn h
LNQDJV, RIZJ	lnqdjv rizj
X, BLWQ	x blwq
GSZ, EM	gsz em
DUOADEB, U	duoadeb u
S, X	s x
GK, QT	gk qt
RR, R	rr r
GC, DVQK	gc dvqk
AS, DWHX	as dwhx
YGYUNNH, CQBL	ygyunnh cqbl
QC, RGG	qc rgg
SAJIPS, KK	sajips kk
O, P	o p
T, WHESKSBZOVN	t whesksbzovn
RVOW, D	rvow d
IEWXCTZ, OVE	iewxctz ove
WQGQK, QQ	wqgqk qq
TYRK, SGLKSEU	tyrk sglkseu
C, DZ	c dz
ZU, SAJAOTC	zu sajaotc
V, U	v u
M, BGA	m bga
O, DB	o db
WRE, LD	wre ld
GI, A	gi a
RO, FEXCSF	ro fexcsf
L, A	l a
UW, E	uw e
BSYS, IRAQM	bsys iraqm
UY, EOK	uy eok
Y, H	y h
U, BHRWLOPLB	u bhrwloplb
X, ATE	x ate
QYRYZ, FAZL	qyryz fazl
NZ, ZA	nz za
T, ZDR	t zdr
O, NZECR	o nzecr
LJGZ, IOAOBO	ljgz ioaobo
RW, WE	rw we
ZB, GIRF	zb girf
ZR, DYL	zr dyl
W, F	w f
NW, Y	nw y
ULTER, SZZN	ulter szzn
PA, H	pa h
E, K	e k
MJ, I	mj i
QFA, D	qfa d
QPL, MYCL	qpl mycl
TYA, LLO	tya llo
TV, UCONOEGH	tv uconoegh
T, R	t r
RPW, T	rpw t
O, YG	o yg
F, C	f c
X, E	x e
H, W	h w
WZ, AI	wz ai
IJAE, E	ijae e
AOKL, F	aokl f
F, RGWY	f rgwy
VQR, M	vqr m
X, YCJ	x ycj
WZP, S	wzp s
DE, V	de v
RMRF, HIVZS	rmrf hivzs
RVRHOWURJWAJGZ, RX	rvrhowurjwajgz rx
D, T	d t
SV, MXX	sv mxx
R, TV	r tv
FP, U	fp u
N, WCHV	n wchv
U, U	u u
VEVNPEO, J	vevnpeo j
NWZ, BHTQWCE	nwz bhtqwce
LNF, F	lnf f
KEL, V	kel v
H, USEL	h usel
F, Q	f q
QVTR, CYXKLSYL	qvtr cyxklsyl
QKOX, ENRV	qkox enrv
RJ, KM	rj km
BOCWMRUZ, KM	bocwmruz km
M, U	m u
NVC, KTF	nvc ktf
DO, WDCHH	do wdchh
LK, K	lk k
K, SMI	k smi
EABX, J	eabx j
U, OV	u ov
YO, VNC	yo vnc
AQ, G	aq g
FJWRNO, T	fjwrno t
S, QJQW	s qjqw
N, TYF	n tyf
JOOX, JRZFC	joox jrzfc
TOEA, NCWZ	toea ncwz
BSCN, D	bscn d
PSOF, X	psof x
X, UF	x uf
KHAWHF, VW	khawhf vw
OLNFXL, QS	olnfxl qs
I, YHN	i yhn
F, F	f f
VZR, K	vzr k
HVHR, VN	hvhr vn
LRTXYOZA, NGP	lrtxyoza ngp
FQM, FE	fqm fe
GMAJ, Y	gmaj y
GL, QZT	gl qzt
Q, RNAM	q rnam
YKW, K	ykw k
THO, BC	tho bc
J, FBH	j fbh
NE, X	ne x
H, K	h k
CAW, JSDQXCXPXVX	caw jsdqxcxpxvx
DUU, Q	duu q
FR, J	fr j
BW, IC	bw ic
M, AF	m af
X, XPBLQKK	x xpblqkk
VD, T	vd t
LSCXCQ, Q	lscxcq q
HJSCU, SVCYGZ	hjscu svcygz
OILWL, B	oilwl b
DHV, V	dhv v
TX, Z	tx z
JKD, ZH	jkd zh
UY, L	uy l
MIOVS, SCJY	miovs scjy
DCXW, OLELE	dcxw olele
KE, LOSEGA	ke losega
LWE, VP	lwe vp
KFOOW, K	kfoow k
QY, HWP	qy hwp
ZWT, I	zwt i
AGMXIQTF, N	agmxiqtf n
S, ETKE	s etke
LP, VU	lp vu
JLLYX, KSJU	jllyx ksju
VDPQ, WOH	vdpq woh
SKWJNW, RNOK	skwjnw rnok
T, G	t g
KV, J	kv j
I, WZ	i wz
LYMRJ, BO	lymrj bo
HCBZM, F	hcbzm f
MZ, T	mz t
XN, RN	xn rn
A, QTOFX	a qtofx
CO, IX	co ix
L, ECVG	l ecvg
HTIH, YFCBOON	htih yfcboon
AFYR, BC	afyr bc
N, XWYIHHV	n xwyihhv
KIFB, WNC	kifb wnc
TZFPRMOHMZ, H	tzfprmohmz h
S, ZKB	s zkb
UOL, YK	uol yk
MBVH, M	mbvh m
ZQ, J	zq j
LW, XLIS	lw xlis
RLDVL, LQACAX	rldvl lqacax
FTN, IJ	ftn ij
L, OJ	l oj
WUHO, MTROECN	wuho mtroecn
ZF, LYB	zf lyb
H, UEDRMPKC	h uedrmpkc
LWOGI, V	lwogi v
IZPDD, PJJJA	izpdd pjjja
L, PQEVGFL	l pqevgfl
H, L	h l
N, FPH	n fph
OO, JHZOY	oo jhzoy
GYJR, RJ	gyjr rj
XC, Z	xc z
O, ED	o ed
EIPNI, M	eipni m
KA, H	ka h
QJUWQ, ZLWYIUB	qjuwq zlwyiub
J, YN	j yn
W, FP	w fp
YZ, CVT	yz cvt
TJEXQ, THU	tjexq thu
BTDZ, P	btdz p
E, LMYNMXN	e lmynmxn
QMX, Q	qmx q
DRSP, B	drsp b
V, T	v t
AH, YCVP	ah ycvp
ZYG, U	zyg u
EZU, VKW	ezu vkw
R, H	r h
Q, W	q w
EZ, F	ez f
FLZM, O	flzm o
SDHCAETZ, E	sdhcaetz e
MOPKW, VSHYE	mopkw vshye
AN, HP	an hp
P, HH	p hh
EHK, UT	ehk ut
J, H	j h
N, H	n h
F, A	f a
AJAOKAG, SAC	ajaokag sac
X, ZRP	x zrp
J, OW	j ow
XNZ, GS	xnz gs
H, B	h b
JD, YD	jd yd
ZN, TJ	zn tj
J, JH	j jh
Y, P	y p
ALE, X	ale x
B, R	b r
XG, XME	xg xme
ER, HH	er hh
K, GB	k gb
RN, V	rn v
PO, R	po r
M, H	m h
PI, G	pi g
WG, FM	wg fm
Q, OIGHL	q oighl
VG, K	vg k
V, N	v n
U, T	u t
OS, Q	os q
T, MY	t my
BZHV, CXQ	bzhv cxq
TE, BVARGBSK	te bvargbsk
SBUEM, T	sbuem t
T, RL	t rl
DKTC, JRCEOD	dktc jrceod
O, Z	o z
N, I	n i
NAFIZ, U	nafiz u
QSC, Z	qsc z
KXNXO, LGA	kxnxo lga
RJ, MOMIJT	rj momijt
VKLP, ZDDI	vklp zddi
GV, JF	gv jf
D, LCDX	d lcdx
M, FMMZGYX	m fmmzgyx
SJ, X	sj x
U, QYK	u qyk
LM, W	lm w
T, R	t r
JHK, MQPE	jhk mqpe
TW, OHIQ	tw ohiq
CD, U	cd u
X, VWK	x vwk
KGIJP, W	kgijp w
E, WDWU	e wdwu
LGK, X	lgk x
XC, Y	xc y
BM, QJ	bm qj
O, VNTE	o vnte
ZGE, RO	zge ro
DOJ, ADRG	doj adrg
X, A	x a
W, P	w p
D, JVX	d jvx
W, LRXTEBAIK	w lrxtebaik
B, DK	b dk
KHD, SXJGDTWS	khd sxjgdtws
QR, RZE	qr rze
AC, XTRK	ac xtrk
CM, R	cm r
BK, MHV	bk mhv
IDXAKW, W	idxakw w
JM, ZRC	jm zrc
IIMZV, P	iimzv p
AG, BIKHAVG	ag bikhavg
VR, D	vr d
KNYFMAJ, B	knyfmaj b
KX, YPKC	kx ypkc
OVAC, GWU	ovac gwu
J, Z	j z
A, LHI	a lhi
H, R	h r
BTKY, Z	btky z
ALWI, QIB	alwi qib
UBQI, FX	ubqi fx
X, UVZVW	x uvzvw
GY, TYG	gy tyg
JFD, FKL	jfd fkl
R, HHJZSELQRA	r hhjzselqra
F, IG	f ig
IEK, X	iek x
N, ZB	n zb
R, AHXA	r ahxa
P, JLE	p jle
U, LJEO	u ljeo
TN, J	tn j
SSJQIS, X	ssjqis x
ES, NGJ	es ngj
I, FZ	i fz
NDY, R	ndy r
QO, QT	qo qt
TG, G	tg g
O, PV	o pv
R, FD	r fd
F, Y	f y
A, ZOZIVU	a zozivu
Q, MKQ	q mkq
HG, U	hg u
KC, Z	kc z
XWRPUZDAS, J	xwrpuzdas j
B, L	b l
Z, T	z t
X, GG	x gg
AV, F	av f
P, UUBOQB	p uuboqb
AD, PIK	ad pik
TY, J	ty j
VYCOH, NR	vycoh nr
PVXSLE, KT	pvxsle kt
C, B	c b
XCM, GH	xcm gh
J, JWQ	j jwq
TUUK, QU	tuuk qu
SM, ZJAO	sm zjao
OU, GPNJQ	ou gpnjq
QD, TEAYLJMR	qd teayljmr
QOTL, O	qotl o
X, TXF	x txf
FLX, AL	flx al
PMVG, KQ	pmvg kq
H, LO	h lo
GH, ZDZI	gh zdzi
JI, PO	ji po
F, ZE	f ze
AQF, JD	aqf jd
P, XMLT	p xmlt
P, OK	p ok
Y, AU	y au
HH, J	hh j
Q, AMI	q ami
X, ZM	x zm
IP, FTRU	ip ftru
YVBRCEF, XWS	yvbrcef xws
Z, M	z m
R, W	r w
Q, GUW	q guw
EDQOUVDCKD, MXL	edqouvdckd mxl
L, J	l j
YDFEK, S	ydfek s
J, XYOBE	j xyobe
GJDSRU, AGT	gjdsru agt
K, F	k f
ISGQ, IRTPDZ	isgq irtpdz
CJ, XV	cj xv
N, HTO	n hto
IM, A	im a
WY, E	wy e
LV, J	lv j
SQ, RBCMXDTZO	sq rbcmxdtzo
W, DC	w dc
B, Y	b y
MQBE, XNNF	mqbe xnnf
CDAEFN, X	cdaefn x
V, SIKGKBU	v sikgkbu
LJJ, WJVLWV	ljj wjvlwv
KWFMWL, KWJE	kwfmwl kwje
N, WHL	n whl
KTF, PZ	ktf pz
DBE, F	dbe f
FTY, M	fty m
M, NPD	m npd
FLL, ZO	fll zo
Z, ZMUMQJ	z zmumqj
LK, BTCJ	lk btcj
RIMAD, ZW	rimad zw
TG, R	tg r
Z, JQ	z jq
JXT, JOX	jxt jox
RBOKOFR, U	rbokofr u
I, SGP	i sgp
ZNLFFJP, AOVGAPP	znlffjp aovgapp
IQ, UE	iq ue
L, LSS	l lss
Z, P	z p
S, J	s j
CC, PU	cc pu
DN, TQCBF	dn tqcbf
HG, O	hg o
A, AS	a as
Q, NVN	q nvn
RN, USQMQ	rn usqmq
WPNMF, U	wpnmf u
V, TTRXB	v ttrxb
HSG, W	hsg w
OB, W	ob w
ABDG, ZIV	abdg ziv
Y, DZOZA	y dzoza
E, W	e w
W, P	w p
V, MHHUFM	v mhhufm
J, D	j d
P, P	p p
BS, Z	bs z
C, U	c u
BRQ, N	brq n
R, DJG	r djg
M, K	m k
NUC, EWP	nuc ewp
N, NN	n nn
TGCW, B	tgcw b
A, C	a c
V, V	v v
YF, F	yf f
E, VLH	e vlh
JJ, IT	jj it
BKT, BI	bkt bi
YO, YB	yo yb
IQ, Q	iq q
WWD, Y	wwd y
MS, O	ms o
I, GLS	i gls
C, R	c r
FJYNYD, R	fjynyd r
XIBG, WD	xibg wd
I, BDU	i bdu
UIDLOL, UEGR	uidlol uegr
ROMGC, K	romgc k
CV, DSMI	cv dsmi
CRENC, UKQEE	crenc ukqee
TQ, EIWLX	tq eiwlx
T, F	t f
HFHPGVWCHO, C	hfhpgvwcho c
B, H	b h
QQDRC, V	qqdrc v
IU, JAU	iu jau
TB, ZO	tb zo
W, LCOKHJ	w lcokhj
I, V	i v
W, C	w c
J, ZIEV	j ziev
CO, W	co w
G, ONO	g ono
M, VXFJP	m vxfjp
OFXTINI, P	ofxtini p
TQ, KEI	tq kei
K, K	k k
XH, B	xh b
KUX, PXO	kux pxo
BD, L	bd l
FX, W	fx w
UO, NRQ	uo nrq
KZL, WKZ	kzl wkz
SJVN, WZ	sjvn wz
G, X	g x
RLHEM, NZ	rlhem nz
L, RCY	l rcy
KC, HJQ	kc hjq
KQ, RNLBH	kq rnlbh
KA, K	ka k
F, L	f l
TE, JH	te jh
L, AFCO	l afco
V, YMH	v ymh
YDGNJ, U	ydgnj u
YKC, KQFG	ykc kqfg
ROAELHCKP, WWS	roaelhckp wws
J, S	j s
DT, Y	dt y
IXR, RL	ixr rl
O, J	o j
X, N	x n
NUVEHU, X	nuvehu x
UZ, J	uz j
ZFP, GNP	zfp gnp
R, A	r a
I, O	i o
GMH, QJ	gmh qj
FOKR, N	fokr n
J, S	j s
GP, P	gp p
YG, BON	yg bon
E, YH	e yh
E, YP	e yp
FLXU, D	flxu d
BP, E	bp e
A, O	a o
H, W	h w
N, ZU	n zu
UMEEA, C	umeea c
B, OPN	b opn
PJZ, L	pjz l
V, IJ	v ij
L, SUXE	l suxe
KY, G	ky g
F, R	f r
VJ, EHNLHZGCVXFA	vj ehnlhzgcvxfa
W, SRSANZ	w srsanz
KYEZ, VHAPL	kyez vhapl
EMVUA, E	emvua e
B, T	b t
O, YXW	o yxw
BG, CXMPERK	bg cxmperk
W, OBTQ	w obtq
W, CQV	w cqv
MBSOL, FWIF	mbsol fwif
IN, HFH	in hfh
N, WBU	n wbu
F, ECSJ	f ecsj
YGVF, EH	ygvf eh
BI, FEZXOK	bi fezxok
UJ, RT	uj rt
K, N	k n
J, KZ	j kz
KJC, Q	kjc q
K, LC	k lc
CZQVBRO, A	czqvbro a
X, JV	x jv
QLO, DK	qlo dk
T, L	t l
X, HO	x ho
F, M	f m
L, V	l v
UG, G	ug g
BDM, J	bdm j
QT, J	qt j
R, DQ	r dq
BMH, HEY	bmh hey
B, CQDJ	b cqdj
HAX, X	hax x
DQ, TYJG	dq tyjg
Q, N	q n
M, RCY	m rcy
NC, C	nc c
JIXDVKU, D	jixdvku d
WE, BFR	we bfr
BEXK, OHSVTSZ	bexk ohsvtsz
EZ, TNJNC	ez tnjnc
X, BY	x by
Y, M	y m
CK, PJGYZ	ck pjgyz
IW, WXDY	iw wxdy
JWI, J	jwi j
O, B	o b
J, K	j k
H, HCR	h hcr
Y, TNWM	y tnwm
U, G	u g
ZYMN, S	zymn s
QJ, HOXT	qj hoxt
U, T	u t
DLPQ, Y	dlpq y
B, KRITBD	b kritbd
M, X	m x
I, HZA	i hza
TV, XBFL	tv xbfl
W, PP	w pp
QR, J	qr j
X, XVX	x xvx
L, A	l a
AR, TOH	ar toh
BX, GX	bx gx
J, GH	j gh
GJM, X	gjm x
AKEHU, PV	akehu pv
KF, UV	kf uv
L, N	l n
MPTUJ, Z	mptuj z
XT, IS	xt is
VE, V	ve v
E, UP	e up
XYFBS, F	xyfbs f
ASP, VF	asp vf
G, E	g e
NL, B	nl b
OX, YAAK	ox yaak
Y, O	y o
R, USG	r usg
JHTOW, ZZVQ	jhtow zzvq
OF, IJ	of ij
C, QLN	c qln
AO, CON	ao con
V, EVRS	v evrs
CHTQH, CPGH	chtqh cpgh
VFPZ, JTBH	vfpz jtbh
KMDS, OHZT	kmds ohzt
MKLJFAEE, RSLPK	mkljfaee rslpk
WBI, M	wbi m
GMA, CQLI	gma cqli
I, VZHB	i vzhb
QKK, QNF	qkk qnf
PX, FP	px fp
HX, O	hx o
YM, RF	ym rf
KZ, P	kz p
QSVP, B	qsvp b
DL, IUBFG	dl iubfg
MNPJ, JV	mnpj jv
Z, UR	z ur
NC, UY	nc uy
I, JI	i ji
LFW, WDE	lfw wde
T, Q	t q
XH, BX	xh bx
F, F	f f
Y, S	y s
DB, HHC	db hhc
QZ, S	qz s
LUZ, Q	luz q
XDWXS, XB	xdwxs xb
S, X	s x
G, D	g d
G, CLR	g clr
LU, SXHJ	lu sxhj
I, RG	i rg
RR, IHF	rr ihf
U, U	u u
U, X	u x
C, IOM	c iom
RAAUPC, EP	raaupc ep
DE, S	de s
BF, QIZKA	bf qizka
LR, L	lr l
M, IR	m ir
TYZDSBPI, Q	tyzdsbpi q
Q, BBSJRHU	q bbsjrhu
HIF, XV	hif xv
VZ, GRF	vz grf
SBX, XB	sbx xb
SKDUX, KPAE	skdux kpae
TXTOIOE, E	txtoioe e
VK, NVRFE	vk nvrfe
PUJ, W	puj w
C, FR	c fr
EQ, YLXDFID	eq ylxdfid
VVTO, XGJGT	vvto xgjgt
P, VTFU	p vtfu
U, ZYS	u zys
ZM, CAH	zm cah
TE, RKQR	te rkqr
LBB, HV	lbb hv
IPKO, F	ipko f
SMSI, H	smsi h
Y, X	y x
EHNNE, V	ehnne v
C, W	c w
WI, U	wi u
IDCEFZGZAAG, K	idcefzgzaag k
NTGFC, HBNDCPQC	ntgfc hbndcpqc
D, ZZY	d zzy
W, C	w c
AS, Z	as z
FLTNHN, Q	fltnhn q
U, GPUZHT	u gpuzht
W, PL	w pl
BLQ, RD	blq rd
P, AN	p an
VF, Z	vf z
VUD, LLQMI	vud llqmi
Z, CB	z cb
QC, P	qc p
K, B	k b
R, F	r f
ENYQ, H	enyq h
V, ULTOCQ	v ultocq
D, Y	d y
V, DGJNGQCJEB	v dgjngqcjeb
M, J	m j
X, U	x u
VIG, D	vig d
MZ, OWW	mz oww
T, ZCP	t zcp
S, L	s l
PETZAW, YYN	petzaw yyn
ODSGY, I	odsgy i
C, KD	c kd
SVWPNG, YFFGMR	svwpng yffgmr
XOBJED, S	xobjed s
COIFUGBV, E	coifugbv e
X, X	x x
MFF, APH	mff aph
GRE, VJ	gre vj
RT, QFHQ	rt qfhq
V, VS	v vs
S, CTCZK	s ctczk
P, VU	p vu
H, X	h x
B, WOOGIZF	b woogizf
EYKY, A	eyky a
AKN, QLPM	akn qlpm
P, QL	p ql
BQ, Q	bq q
RG, M	rg m
F, TAVWZ	f tavwz
RY, MFR	ry mfr
Q, UF	q uf
U, H	u h
US, YQ	us yq
KIPGRT, XF	kipgrt xf
RZSGBY, EZQ	rzsgby ezq
RH, OBV	rh obv
ZVWVGB, EB	zvwvgb eb
R, WP	r wp
QLR, F	qlr f
MM, PSKWWH	mm pskwwh
XUJZ, B	xujz b
E, X	e x
Q, V	q v
Q, F	q f
DXZPTSDSO, YEO	dxzptsdso yeo
M, U	m u
BTXIU, G	btxiu g
SASQNW, ONTM	sasqnw ontm
L, L	l l
PH, G	ph g
YVAKOE, T	yvakoe t
RB, F	rb f
FI, AYSCKAB	fi aysckab
L, L	l l
A, GWZ	a gwz
UK, B	uk b
O, RRYATVJ	o rryatvj
M, UXP	m uxp
Q, C	q c
DCWQ, E	dcwq e
RG, D	rg d
S, HLN	s hln
K, FDO	k fdo
B, XN	b xn
ZGOQJ, MWAKA	zgoqj mwaka
D, K	d k
PM, E	pm e
EF, NO	ef no
SN, IM	sn im
G, RZW	g rzw
XI, EE	xi ee
EKXU, BWVY	ekxu bwvy
WF, SDIHN	wf sdihn
I, BU	i bu
U, R	u r
KRMJQQ, MVL	krmjqq mvl
DD, R	dd r
LRN, V	lrn v
PLN, NAGB	pln nagb
EDB, T	edb t
MGM, W	mgm w
SREMA, DYZK	srema dyzk
MW, A	mw a
QWC, TS	qwc ts
RJKF, IS	rjkf is
N, JEJBGE	n jejbge
PAN, O	pan o
HWK, Z	hwk z
DH, DH	dh dh
DTXPP, AYE	dtxpp aye
I, Y	i y
KPW, IP	kpw ip
B, IF	b if
YA, XJF	ya xjf
VWK, A	vwk a
ESU, FCOJ	esu fcoj
JI, QQ	ji qq
VWEL, L	vwel l
WYM, FJEG	wym fjeg
V, P	v p
D, UKPPC	d ukppc
D, F	d f
VKM, I	vkm i
NZWV, I	nzwv i
QXAUVJ, WGB	qxauvj wgb
ZFD, P	zfd p
EWR, UA	ewr ua
D, N	d n
T, T	t t
SQM, MM	sqm mm
Q, A	q a
P, SQ	p sq
N, CMN	n cmn
AW, R	aw r
AL, G	al g
IY, WLU	iy wlu
O, M	o m
DA, TTHNLGFO	da tthnlgfo
K, FYD	k fyd
AM, QUF	am quf
TGY, DRFLVVBSF	tgy drflvvbsf
U, OH	u oh
ZAQNGUCZ, EE	zaqngucz ee
YO, YV	yo yv
A, F	a f
S, VG	s vg
P, IR	p ir
FTTUBS, C	fttubs c
H, Z	h z
G, QP	g qp
L, EIX	l eix
U, B	u b
BFQV, D	bfqv d
VR, NL	vr nl
A, GT	a gt
R, N	r n
K, GOC	k goc
N, EHP	n ehp
P, GP	p gp
CE, BHP	ce bhp
X, B	x b
PRPW, BT	prpw bt
BHFRNMXLQ, B	bhfrnmxlq b
K, FMVB	k fmvb
Z, RZA	z rza
IUEI, U	iuei u
Z, H	z h
SH, OT	sh ot
RKEPNT, VTAZOSEC	rkepnt vtazosec
Y, WIXW	y wixw
SOX, O	sox o
VR, SNII	vr snii
WOF, C	wof c
OCL, P	ocl p
CCPDC, H	ccpdc h
J, XAN	j xan
OE, K	oe k
XAL, ZEC	xal zec
YXG, J	yxg j
RMU, QY	rmu qy
G, HLW	g hlw
EX, B	ex b
AR, WZY	ar wzy
ZV, HJH	zv hjh
RE, UKW	re ukw
P, C	p c
Y, I	y i
IOZL, EWOU	iozl ewou
AS, Q	as q
I, ZVHMTKW	i zvhmtkw
D, ZWX	d zwx
AHTJTMXY, LGBDT	ahtjtmxy lgbdt
T, I	t i
TVZ, E	tvz e
SLCQFWYNBC, EEYGB	slcqfwynbc eeygb
I, P	i p
JAXN, R	jaxn r
ZIEK, CGYM	ziek cgym
FFM, MISFYETE	ffm misfyete
F, LL	f ll
R, DO	r do
PY, N	py n
ZWW, F	zww f
R, Z	r z
X, FW	x fw
ODK, F	odk f
TC, QYN	tc qyn
S, MCY	s mcy
RVPK, Y	rvpk y
X, IZXZM	x izxzm
GZ, MF	gz mf
WDFFVU, M	wdffvu m
NE, DU	ne du
MO, O	mo o
AZVQD, UFA	azvqd ufa
RZRABQZCC, K	rzrabqzcc k
WSC, HPGUMFEARFJZ	wsc hpgumfearfjz
ZN, Z	zn z
Z, BT	z bt
VK, OG	vk og
VXFBW, DL	vxfbw dl
K, QZ	k qz
F, QS	f qs
V, E	v e
FNZMK, IEFT	fnzmk ieft
W, A	w a
UF, NJ	uf nj
M, CCH	m cch
R, F	r f
V, Y	v y
ELFXJ, FHF	elfxj fhf
XENC, X	xenc x
TSU, QE	tsu qe
BSOE, EELCOL	bsoe eelcol
PEXCL, WF	pexcl wf
URQS, AUM	urqs aum
I, OPE	i ope
J, AL	j al
RNV, IT	rnv it
N, E	n e
Q, R	q r
W, M	w m
PW, JWQ	pw jwq
T, FEFX	t fefx
L, R	l r
PJ, UZQ	pj uzq
CQCCYU, VSA	cqccyu vsa
D, L	d l
JTND, LDT	jtnd ldt
M, A	m a
GMGMXIH, SFR	gmgmxih sfr
UWCCZ, R	uwccz r
N, PS	n ps
R, W	r w
X, W	x w
TLHSX, NYJ	tlhsx nyj
GNYXE, BT	gnyxe bt
LIP, DW	lip dw
CXJLXUCASP, EEDX	cxjlxucasp eedx
S, BH	s bh
V, JVQPBRU	v jvqpbru
Y, Z	y z
N, Z	n z
BHWYA, W	bhwya w
KLBGH, DKY	klbgh dky
AEWAGN, J	aewagn j
OI, T	oi t
TFZTYC, GFARWNMSLESU	tfztyc gfarwnmslesu
CE, DG	ce dg
G, EQCSE	g eqcse
MZZ, ADZW	mzz adzw
HVL, X	hvl x
J, R	j r
O, SPOU	o spou
FV, TN	fv tn
ZE, CPE	ze cpe
S, O	s o
Y, DCI	y dci
OT, UCGG	ot ucgg
KEFMY, LPHIRG	kefmy lphirg
PXZZPZMBWCV, G	pxzzpzmbwcv g
C, SHTI	c shti
SHO, R	sho r
KPC, FJ	kpc fj
QQL, KD	qql kd
M, D	m d
E, GR	e gr
KI, Z	ki z
ANJG, O	anjg o
GO, UU	go uu
S, FUZRNR	s fuzrnr
Q, SA	q sa
AZDP, S	azdp s
Q, ZP	q zp
C, SGP	c sgp
V, HFJ	v hfj
BKLN, UUX	bkln uux
BP, G	bp g
DW, B	dw b
PBZ, MBY	pbz mby
CTQ, EYXKJ	ctq eyxkj
TYL, TMD	tyl tmd
Z, P	z p
S, C	s c
US, YBQWVE	us ybqwve
SCK, R	sck r
Z, VER	z ver
C, NU	c nu
Y, XH	y xh
D, CB	d cb
E, WAE	e wae
C, S	c s
D, VIHOF	d vihof
E, N	e n
V, RWG	v rwg
BW, B	bw b
JVNMW, U	jvnmw u
YCQS, W	ycqs w
FZNE, YK	fzne yk
SM, B	sm b
JRM, Y	jrm y
YALM, LRP	yalm lrp
JOVUT, LB	jovut lb
EVBXE, BOAGA	evbxe boaga
NK, P	nk p
AAQ, M	aaq m
A, RV	a rv
RFC, FAT	rfc fat
C, D	c d
D, BTGHG	d btghg
R, IILQ	r iilq
G, T	g t
XA, QXKZVJ	xa qxkzvj
FPUJLC, LLT	fpujlc llt
V, TFC	v tfc
UK, WOA	uk woa
YGY, K	ygy k
KZN, DCJ	kzn dcj
VJ, DFTB	vj dftb
N, V	n v
NX, L	nx l
LW, H	lw h
DPFO, P	dpfo p
T, J	t j
AM, H	am h
V, JMIQ	v jmiq
C, C	c c
YVHQ, FYHWB	yvhq fyhwb
U, HD	u hd
RL, MO	rl mo
TXXLWDS, N	txxlwds n
BHMDTSZ, J	bhmdtsz j
E, U	e u
ZJ, AXH	zj axh
EK, NCR	ek ncr
CN, O	cn o
I, LJF	i ljf
JSHG, B	jshg b
LEUZFVYMHD, LKJJX	leuzfvymhd lkjjx
R, K	r k
S, F	s f
AZJDTK, BB	azjdtk bb
QZULWEAQYVX, Y	qzulweaqyvx y
GH, T	gh t
BJT, DJD	bjt djd
CF, I	cf i
P, T	p t
N, O	n o
ZY, SRY	zy sry
D, GPV	d gpv
G, F	g f
BYSOLVOQ, ILU	bysolvoq ilu
K, VZY	k vzy
LE, OLZ	le olz
Z, N	z n
PJ, EQKZ	pj eqkz
YCE, AA	yce aa
B, C	b c
G, WEC	g wec
CRW, Q	crw q
DA, U	da u
NKU, SFF	nku sff
DPQ, VMTON	dpq vmton
FC, TCQ	fc tcq
PQ, K	pq k
E, C	e c
MBNEVE, H	mbneve h
IH, CF	ih cf
OG, IW	og iw
LS, B	ls b
MZOZP, X	mzozp x
SMIYHUK, ENAHPJINVG	smiyhuk enahpjinvg
Z, NI	z ni
KOS, K	kos k
JW, G	jw g
OF, U	of u
CIGR, C	cigr c
CC, F	cc f
FRZ, WW	frz ww
M, JBL	m jbl
IVNTS, JL	ivnts jl
ONE, Y	one y
CZPW, U	czpw u
H, B	h b
G, WZQZGWC	g wzqzgwc
JF, YY	jf yy
D, H	d h
SZE, HTT	sze htt
F, K	f k
BVCZYB, IOKDB	bvczyb iokdb
V, N	v n
GA, R	ga r
ZI, IA	zi ia
OYX, YWQ	oyx ywq
EDL, I	edl i
P, LT	p lt
Y, J	y j
OO, SWD	oo swd
QKPZ, FG	qkpz fg
ITMCI, C	itmci c
WQET, JWF	wqet jwf
R, L	r l
ZDO, X	zdo x
OEVK, N	oevk n
H, FBKVT	h fbkvt
EZ, R	ez r
AYP, IWR	ayp iwr
VILD, K	vild k
KC, I	kc i
V, PV	v pv
VI, T	vi t
CWO, I	cwo i
V, LYMLH	v lymlh
Q, SCO	q sco
OHEQ, CVI	oheq cvi
IFKPDUTAH, UWXX	ifkpdutah uwxx
K, J	k j
C, IW	c iw
QL, ZN	ql zn
T, O	t o
RHZY, A	rhzy a
E, LRLVD	e lrlvd
FX, ALSVM	fx alsvm
Y, MYP	y myp
E, Z	e z
MCW, PD	mcw pd
EXLWEK, IKDV	exlwek ikdv
Y, AXBE	y axbe
BUI, PVG	bui pvg
O, E	o e
J, TS	j ts
Z, SA	z sa
X, CE	x ce
VB, LFL	vb lfl
SDNLSO, W	sdnlso w
MULC, D	mulc d
V, TLFRP	v tlfrp
GI, L	gi l
TM, EJJW	tm ejjw
WFMFISGBC, X	wfmfisgbc x
Q, HX	q hx
M, IS	m is
I, WBUG	i wbug
XH, RWDQY	xh rwdqy
SU, T	su t
FNMQ, UPAVCAX	fnmq upavcax
GTH, NLIF	gth nlif
FO, M	fo m
F, E	f e
H, Q	h q
L, NV	l nv
HKOA, F	hkoa f
UMQVRD, JW	umqvrd jw
ZC, RREDY	zc rredy
KW, OS	kw os
D, TWRI	d twri
PNLXGYGI, XR	pnlxgygi xr
E, KAROAB	e karoab
OAKF, Q	oakf q
RP, WFKN	rp wfkn
KNZ, HM	knz hm
Q, J	q j
K, AR	k ar
B, M	b m
G, V	g v
QFDXVCJX, Z	qfdxvcjx z
M, E	m e
TZER, D	tzer d
DAJAPB, J	dajapb j
P, TQZZAMF	p tqzzamf
LCHK, NL	lchk nl
ZO, SGKRSSUH	zo sgkrssuh
JEWD, ILJW	jewd iljw
Z, OB	z ob
HYSSS, NOMWKW	hysss nomwkw
NWR, CW	nwr cw
GWF, DJ	gwf dj
Y, W	y w
D, WX	d wx
QE, X	qe x
PGD, JXJDA	pgd jxjda
LKZ, AOF	lkz aof
VA, S	va s
MII, LX	mii lx
MHLEA, T	mhlea t
M, H	m h
LON, OKG	lon okg
F, NBC	f nbc
NM, OCCWMI	nm occwmi
FBQ, YX	fbq yx
TMY, MG	tmy mg
GF, Z	gf z
VS, TL	vs tl
GSYXKW, R	gsyxkw r
MYPSL, FW	mypsl fw
FO, I	fo i
G, Z	g z
A, TESL	a tesl
EJPEBF, Y	ejpebf y
Y, P	y p
W, R	w r
Z, V	z v
KQA, X	kqa x
ICR, E	icr e
P, JMBHW	p jmbhw
MP, OYZ	mp oyz
FM, MV	fm mv
T, C	t c
CA, QJTPTA	ca qjtpta
YGK, KI	ygk ki
S, Z	s z
BHBW, I	bhbw i
S, LW	s lw
Y, F	y f
K, BVDBW	k bvdbw
TZ, A	tz a
X, LVPLPC	x lvplpc
GKK, DXVRAZE	gkk dxvraze
SGQQZ, P	sgqqz p
C, OG	c og
B, XTX	b xtx
H, XNP	h xnp
WZODK, Y	wzodk y
RSTLISB, GP	rstlisb gp
XX, PMZU	xx pmzu
N, OJ	n oj
W, UDF	w udf
WIJ, K	wij k
ZCRYHQR, NYTI	zcryhqr nyti
HKLDM, DQICA	hkldm dqica
WF, H	wf h
M, W	m w
PKGE, Y	pkge y
U, E	u e
NXGB, VYTID	nxgb vytid
V, TSRX	v tsrx
C, F	c f
TC, EYF	tc eyf
HM, J	hm j
QOIJC, F	qoijc f
V, DW	v dw
VH, Q	vh q
ZA, TX	za tx
PF, A	pf a
HUHEYYV, TXG	huheyyv txg
PA, YY	pa yy
C, OEQRPVVQ	c oeqrpvvq
LEG, FUO	leg fuo
VKECY, DC	vkecy dc
K, UCIU	k uciu
DX, FRVVY	dx frvvy
MQA, GTQ	mqa gtq
WVCRRY, S	wvcrry s
XV, F	xv f
NUMOPOT, T	numopot t
A, VMR	a vmr
G, WSYXC	g wsyxc
WXGC, QGD	wxgc qgd
MTKTC, ELBU	mtktc elbu
XB, Q	xb q
W, J	w j
RE, WD	re wd
XMM, W	xmm w
IQ, UIZ	iq uiz
QVC, CC	qvc cc
QUMXJZ, SJC	qumxjz sjc
YMX, QMJFBJS	ymx qmjfbjs
JJW, MG	jjw mg
ZS, UW	zs uw
US, Z	us z
MUBB, T	mubb t
GF, O	gf o
W, TXUXHAE	w txuxhae
D, R	d r
V, P	v p
XTFTE, F	xtfte f
I, TX	i tx
WF, LRA	wf lra
N, PWX	n pwx
JTWBB, OZ	jtwbb oz
X, Q	x q
E, IA	e ia
KBD, HSRY	kbd hsry
AFSGWGQVQ, JFO	afsgwgqvq jfo
X, S	x s
Z, J	z j
WAU, T	wau t
LS, PA	ls pa
K, OZOJ	k ozoj
MS, K	ms k
PMDU, RS	pmdu rs
WD, G	wd g
K, FFK	k ffk
UCEC, A	ucec a
JM, QYHH	jm qyhh
Z, Q	z q
GVY, YO	gvy yo
QE, O	qe o
F, XN	f xn
ZH, M	zh m
A, ZXIKL	a zxikl
MU, OLRVE	mu olrve
WRAPV, A	wrapv a
AUD, H	aud h
TES, CBHONRUQH	tes cbhonruqh
ANX, U	anx u
ZWKEE, LOY	zwkee loy
R, QRA	r qra
OIUEY, Q	oiuey q
HVWV, ZY	hvwv zy
CE, AUXM	ce auxm
JTAQT, U	jtaqt u
LZ, BUO	lz buo
PE, W	pe w
C, SLJ	c slj
Z, O	z o
KD, X	kd x
JH, N	jh n
O, Z	o z
HGRF, CX	hgrf cx
LP, AJ	lp aj
WIZP, J	wizp j
WDJ, I	wdj i
XKD, PO	xkd po
Z, XU	z xu
G, L	g l
K, Q	k q
K, NUN	k nun
Q, QP	q qp
AIVNQ, JQVO	aivnq jqvo
IUA, SI	iua si
OHT, NCK	oht nck
IR, DMT	ir dmt
I, LT	i lt
W, Q	w q
E, ACSD	e acsd
F, I	f i
UA, K	ua k
C, C	c c
GYE, W	gye w
DSJXI, I	dsjxi i
AR, LT	ar lt
N, O	n o
O, AY	o ay
SKFG, BGF	skfg bgf
B, Q	b q
Y, R	y r
T, C	t c
FWH, JLRYXT	fwh jlryxt
L, TB	l tb
RKY, VZ	rky vz
L, UFQL	l ufql
RHYLCUOMINUJ, CNFAS	rhylcuominuj cnfas
C, VT	c vt
DDSS, SHT	ddss sht
URFLTA, H	urflta h
B, EBQMKZV	b ebqmkzv
J, WQTGVZC	j wqtgvzc
SAUZ, IJW	sauz ijw
G, B	g b
OA, M	oa m
R, DITCL	r ditcl
DIZ, GAF	diz gaf
M, W	m w
C, PTVY	c ptvy
QLGFXKYYV, ROZZZA	qlgfxkyyv rozzza
Q, PYLPO	q pylpo
B, U	b u
ES, K	es k
O, FG	o fg
W, V	w v
U, MY	u my
OD, LRQY	od lrqy
H, QWN	h qwn
E, G	e g
H, H	h h
WC, T	wc t
FJWBE, UZEH	fjwbe uzeh
FBJXOIL, UR	fbjxoil ur
SUMH, WXN	sumh wxn
LQ, PFZ	lq pfz
FPZ, GJ	fpz gj
LMB, I	lmb i
DDIH, U	ddih u
QCSKPMR, MN	qcskpmr mn
OW, XVPDOGPLVVSGF	ow xvpdogplvvsgf
WD, W	wd w
BLD, X	bld x
E, B	e b
PP, FXS	pp fxs
F, M	f m
P, TCQBRPG	p tcqbrpg
Y, M	y m
N, YGTJVC	n ygtjvc
MP, Z	mp z
FHF, Q	fhf q
J, YKIV	j ykiv
BU, DM	bu dm
QB, XO	qb xo
GNIZ, AC	gniz ac
T, O	t o
EQVWV, WILX	eqvwv wilx
IXE, KAL	ixe kal
BW, UO	bw uo
A, H	a h
U, OD	u od
FQE, I	fqe i
VP, D	vp d
VZQLYP, DV	vzqlyp dv
T, WEPOX	t wepox
C, RJY	c rjy
V, M	v m
B, LK	b lk
Q, QYM	q qym
XS, WWDU	xs wwdu
Y, C	y c
S, EXFDEAE	s exfdeae
PS, Z	ps z
HOC, MS	hoc ms
PJC, AL	pjc al
N, FWAT	n fwat
U, G	u g
NXE, YP	nxe yp
V, K	v k
LCEW, TG	lcew tg
MADBKB, BC	madbkb bc
Z, DQQW	z dqqw
NU, ZIH	nu zih
RPHMXAN, DG	rphmxan dg
W, IH	w ih
NAZLFZCMCY, ES	nazlfzcmcy es
EQ, R	eq r
ZNMLV, T	znmlv t
YS, QXGUAM	ys qxguam
R, BE	r be
D, EE	d ee
L, MB	l mb
Z, BE	z be
N, PP	n pp
B, K	b k
CK, M	ck m
NI, H	ni h
H, T	h t
GE, PF	ge pf
MN, P	mn p
OARM, RSXLB	oarm rsxlb
CBVH, TAG	cbvh tag
GPD, IUJ	gpd iuj
XQ, UTDXY	xq utdxy
EULEW, ZHS	eulew zhs
D, HIUHZDF	d hiuhzdf
JKF, XDSI	jkf xdsi
WV, EJOJ	wv ejoj
KBKM, H	kbkm h
FZAJNCJ, Q	fzajncj q
T, FYENDM	t fyendm
SMCU, BEILY	smcu beily
S, Z	s z
G, JRYAF	g jryaf
QRNZ, TFLZNRO	qrnz tflznro
WMCXB, HL	wmcxb hl
SKMZSL, W	skmzsl w
G, NEOWT	g neowt
U, VT	u vt
CD, S	cd s
H, GE	h ge
BDRJ, GIF	bdrj gif
ZRDGHQ, RG	zrdghq rg
DR, XJ	dr xj
WXH, O	wxh o
NN, CK	nn ck
A, AW	a aw
SEN, HJ	sen hj
B, LIHVQ	b lihvq
RZFI, YHIX	rzfi yhix
YB, YYL	yb yyl
M, ID	m id
RU, PBO	ru pbo
A, S	a s
ES, J	es j
XE, A	xe a
DU, GP	du gp
W, C	w c
FLXMP, AWPN	flxmp awpn
M, RVGXQE	m rvgxqe
X, C	x c
R, CA	r ca
ACFV, UX	acfv ux
PE, WHE	pe whe
NA, U	na u
U, GEP	u gep
Y, N	y n
JJZ, GMZTPAWQHSTU	jjz gmztpawqhstu
J, RMU	j rmu
P, P	p p
DV, U	dv u
G, JMT	g jmt
IVW, NNHY	ivw nnhy
A, QXPIGT	a qxpigt
CRG, OA	crg oa
H, HOSL	h hosl
TNEHWC, H	tnehwc h
QQ, GXMD	qq gxmd
WXLNFY, QF	wxlnfy qf
C, QRZFJMQTW	c qrzfjmqtw
OVL, TDZ	ovl tdz
L, PBWZGK	l pbwzgk
IMFKD, UKIK	imfkd ukik
DZIPVEV, OA	dzipvev oa
OO, PUF	oo puf
K, ZV	k zv
P, GWJ	p gwj
C, AFAZ	c afaz
NSKNFIS, C	nsknfis c
WCIYBDZPP, SK	wciybdzpp sk
XH, H	xh h
DUDPYUQ, IBF	dudpyuq ibf
BWRSZ, GSG	bwrsz gsg
R, FN	r fn
BKTDW, LQ	bktdw lq
F, NOQ	f noq
JKI, H	jki h
AGF, FLUYFYO	agf fluyfyo
W, TSLI	w tsli
RLPM, VAP	rlpm vap
LCY, QP	lcy qp
FDX, I	fdx i
YOP, JTV	yop jtv
W, L	w l
SS, FXQFCR	ss fxqfcr
XOSOCT, UAUXR	xosoct uauxr
C, VE	c ve
NQ, PN	nq pn
EG, U	eg u
AXFR, UUJ	axfr uuj
YF, H	yf h
IWRH, GN	iwrh gn
R, I	r i
C, N	c n
FGCH, UFAOW	fgch ufaow
H, FTI	h fti
G, QR	g qr
K, FIF	k fif
WOZ, X	woz x
UG, QSGQR	ug qsgqr
CI, SP	ci sp
HMYWQZP, AR	hmywqzp ar
Y, IM	y im
M, FBO	m fbo
G, LLYNX	g llynx
VZ, WG	vz wg
ZEMJGVJ, KYX	zemjgvj kyx
VQ, K	vq k
X, W	x w
DKQUN, F	dkqun f
KNLN, OD	knln od
HCP, YMJXK	hcp ymjxk
D, V	d v
E, YNTDG	e yntdg
R, EH	r eh
L, A	l a
AL, NTNBD	al ntnbd
F, BDTCUBYQUUX	f bdtcubyquux
S, OCIM	s ocim
VYAR, NGH	vyar ngh
U, RL	u rl
ZBIZZ, V	zbizz v
FVOYG, B	fvoyg b
XIDNI, G	xidni g
AD, G	ad g
O, T	o t
IDP, LEHS	idp lehs
W, V	w v
L, X	l x
DH, XUP	dh xup
DO, S	do s
C, QVDCZFTY	c qvdczfty
S, NNOQHC	s nnoqhc
MRRDGA, GH	mrrdga gh
NVG, U	nvg u
B, M	b m
LEYV, Z	leyv z
X, D	x d
QMHYF, M	qmhyf m
L, YW	l yw
V, YB	v yb
AQKQ, VPJ	aqkq vpj
P, F	p f
NA, AKTGS	na aktgs
Z, UJZ	z ujz
F, G	f g
U, YRWW	u yrww
EO, A	eo a
VF, VJS	vf vjs
M, B	m b
T, HR	t hr
VA, W	va w
W, U	w u
AOPWADJW, Y	aopwadjw y
GSVL, PFQ	gsvl pfq
Z, RBETNO	z rbetno
YDMYE, PUHSN	ydmye puhsn
W, O	w o
CZH, G	czh g
IQ, I	iq i
DRWDTNZ, PAE	drwdtnz pae
M, J	m j
XDL, CFRU	xdl cfru
I, H	i h
P, SE	p se
OPH, BI	oph bi
T, JV	t jv
I, QWQ	i qwq
A, YL	a yl
E, LMFV	e lmfv
FL, MHJ	fl mhj
XUTSJB, TKIDDGJ	xutsjb tkiddgj
E, ERV	e erv
IJNMOTZ, H	ijnmotz h
NDJ, SB	ndj sb
W, TZ	w tz
NAZT, P	nazt p
N, O	n o
LTACE, C	ltace c
EP, IRA	ep ira
K, OMFFWS	k omffws
S, Y	s y
Z, RQ	z rq
ZI, YVQ	zi yvq
Q, AEF	q aef
QUB, C	qub c
M, V	m v
XZ, MG	xz mg
NOCD, E	nocd e
UV, QTJVIV	uv qtjviv
BH, D	bh d
OSJRBE, LLB	osjrbe llb
W, B	w b
OJPAAU, A	ojpaau a
T, ZJR	t zjr
CE, U	ce u
Y, DSBO	y dsbo
GP, KISWBDTJ	gp kiswbdtj
CPNR, GC	cpnr gc
I, HYS	i hys
PEJE, HAW	peje haw
XHA, JTJK	xha jtjk
T, O	t o
ZK, VT	zk vt
Y, MRSTDUUJ	y mrstduuj
Q, EFOE	q efoe
T, QMKJQGUT	t qmkjqgut
CGQSPSL, S	cgqspsl s
PXAGE, AM	pxage am
B, WRY	b wry
VAD, PRO	vad pro
NSK, HEYDG	nsk heydg
ZJ, F	zj f
EMI, ULYF	emi ulyf
B, BO	b bo
I, LP	i lp
H, LK	h lk
JSWQ, Q	jswq q
D, HL	d hl
H, DEV	h dev
B, O	b o
UZ, K	uz k
WO, D	wo d
CH, C	ch c
CI, VVV	ci vvv
VOQI, JNLG	voqi jnlg
ZWEA, FV	zwea fv
H, BHFVIESQA	h bhfviesqa
SGP, ZHTYZAT	sgp zhtyzat
P, TWL	p twl
J, RWX	j rwx
UZPNTVF, S	uzpntvf s
FHM, H	fhm h
IBOXGFRXRYDB, F	iboxgfrxrydb f
AHI, X	ahi x
TR, M	tr m
DWUCB, PCBECWP	dwucb pcbecwp
S, I	s i
B, EO	b eo
N, ZP	n zp
G, DBC	g dbc
CD, W	cd w
ZDH, N	zdh n
M, BA	m ba
QC, F	qc f
HTTBPM, LAED	httbpm laed
IXZL, MO	ixzl mo
R, NY	r ny
L, E	l e
O, OT	o ot
XQ, J	xq j
FY, LA	fy la
D, GT	d gt
TTVA, HK	ttva hk
PNNDA, OAGH	pnnda oagh
ANX, L	anx l
LZPHILX, AUH	lzphilx auh
F, GWO	f gwo
P, VA	p va
U, ESIA	u esia
WNB, Y	wnb y
MW, UCI	mw uci
X, P	x p
A, VJHHOMR	a vjhhomr
N, UR	n ur
JKJU, KNEF	jkju knef
M, LGEQFUA	m lgeqfua
C, LT	c lt
MM, WJ	mm wj
L, M	l m
I, L	i l
CM, T	cm t
BXJ, TU	bxj tu
ZCPL, CKP	zcpl ckp
VA, ID	va id
V, VS	v vs
B, D	b d
KIGP, DH	kigp dh
FBZ, K	fbz k
F, T	f t
KUFHBLYP, TKFA	kufhblyp tkfa
LFSBOYA, P	lfsboya p
QM, CFM	qm cfm
N, S	n s
NMAX, I	nmax i
ATL, Z	atl z
VIL, PBL	vil pbl
GS, U	gs u
GT, FC	gt fc
M, Y	m y
R, H	r h
H, WYN	h wyn
QVJXA, H	qvjxa h
EWG, R	ewg r
ROR, J	ror j
F, L	f l
UOB, CL	uob cl
L, AF	l af
EKNI, YBCZ	ekni ybcz
GGFPV, SVO	ggfpv svo
IP, K	ip k
MWF, GN	mwf gn
M, EK	m ek
TBMWRF, L	tbmwrf l
V, O	v o
DM, OFHU	dm ofhu
UNS, C	uns c
A, G	a g
GS, T	gs t
C, H	c h
SCKIDEU, A	sckideu a
MC, BAIK	mc baik
Z, QK	z qk
VNGSMVWN, Q	vngsmvwn q
L, M	l m
UKH, YG	ukh yg
O, X	o x
V, JRKMBFFWQ	v jrkmbffwq
IBA, QXPX	iba qxpx
K, BWJNW	k bwjnw
RCQS, T	rcqs t
XG, S	xg s
FKIEZ, X	fkiez x
OH, SK	oh sk
IP, U	ip u
E, DH	e dh
KCLEQA, JTHMDA	kcleqa jthmda
OY, J	oy j
JBHXF, JDQKBCO	jbhxf jdqkbco
BU, B	bu b
SQ, DE	sq de
YQ, Q	yq q
O, RW	o rw
K, A	k a
H, FBJ	h fbj
O, A	o a
GOY, SRH	goy srh
ON, OQHN	on oqhn
Y, WUHT	y wuht
Z, KY	z ky
LWO, NZG	lwo nzg
E, R	e r
Q, WIXUKNEHCFE	q wixuknehcfe
PF, SOOF	pf soof
PI, AR	pi ar
EUAH, O	euah o
TYOHD, TL	tyohd tl
JL, WGDKPC	jl wgdkpc
RFCTKO, TT	rfctko tt
V, YLPUOJT	v ylpuojt
B, WTB	b wtb
XHQ, WWRDL	xhq wwrdl
TXSWDPC, IRXEKBA	txswdpc irxekba
YEK, O	yek o
EZU, I	ezu i
TC, WYW	tc wyw
U, VB	u vb
U, T	u t
U, MV	u mv
NVZBC, CY	nvzbc cy
L, TYLYB	l tylyb
U, HDXLK	u hdxlk
S, A	s a
U, XH	u xh
WTFN, W	wtfn w
Q, IP	q ip
VV, PM	vv pm
R, X	r x
L, J	l j
W, K	w k
RQQ, D	rqq d
NKF, WNJB	nkf wnjb
OLA, P	ola p
E, D	e d
E, WF	e wf
KNKIZSDSQUSJGVAW, WG	knkizsdsqusjgvaw wg
E, Q	e q
O, SJ	o sj
W, TZKPKYUAE	w tzkpkyuae
RFHSUA, GPY	rfhsua gpy
ACBZ, Y	acbz y
U, Y	u y
P, C	p c
IWOOGNW, Q	iwoognw q
O, KUZXX	o kuzxx
ABSFGRRTR, DJY	absfgrrtr djy
M, XG	m xg
WPQ, FMQNOLBH	wpq fmqnolbh
LN, DB	ln db
HOV, I	hov i
N, J	n j
SOEWXPDV, S	soewxpdv s
BNM, LH	bnm lh
L, FRG	l frg
VG, E	vg e
HI, R	hi r
GJ, OOA	gj ooa
CRXN, U	crxn u
W, F	w f
D, I	d i
F, O	f o
I, Q	i q
BZ, EIW	bz eiw
RAUTNY, PS	rautny ps
UU, N	uu n
TJ, WQDN	tj wqdn
D, MKE	d mke
U, GB	u gb
V, R	v r
K, O	k o
VAVC, R	vavc r
K, X	k x
QITE, RX	qite rx
H, WWO	h wwo
XX, KIE	xx kie
RUTZ, A	rutz a
M, E	m e
QO, ZL	qo zl
WM, NBV	wm nbv
ZXGBLR, D	zxgblr d
LB, OC	lb oc
Q, N	q n
DOD, UZ	dod uz
UWEAMI, MG	uweami mg
L, ES	l es
KB, EJE	kb eje
L, ST	l st
ZD, YVFA	zd yvfa
KUTN, Y	kutn y
EAD, KJMAKQA	ead kjmakqa
O, CA	o ca
MT, JH	mt jh
XBNT, DV	xbnt dv
B, K	b k
P, F	p f
WFRJOX, KMEUU	wfrjox kmeuu
T, XKBPQT	t xkbpqt
J, KE	j ke
BTQ, J	btq j
G, YNZSMJ	g ynzsmj
VIXBQ, TJJ	vixbq tjj
G, Q	g q
KX, OV	kx ov
P, FU	p fu
GVYFI, QA	gvyfi qa
X, O	x o
K, L	k l
FQ, ERQF	fq erqf
UA, S	ua s
R, F	r f
MA, V	ma v
QHE, C	qhe c
MZWI, KP	mzwi kp
FA, OUM	fa oum
Z, T	z t
L, C	l c
ZN, YLGZJF	zn ylgzjf
BPLR, CKN	bplr ckn
FKG, W	fkg w
TB, FZQEQLN	tb fzqeqln
U, K	u k
WO, WMGQDBE	wo wmgqdbe
PI, DXYL	pi dxyl
GD, D	gd d
BXO, Z	bxo z
V, AD	v ad
J, GKCNM	j gkcnm
WQMBDGNUS, ZL	wqmbdgnus zl
PS, UABPWODYGFI	ps uabpwodygfi
AOY, SZ	aoy sz
I, TZTRYLG	i tztrylg
OY, ENZYH	oy enzyh
S, D	s d
K, RFZ	k rfz
QJXYEDCQP, GUP	qjxyedcqp gup
PAEMHIM, U	paemhim u
BFOIKCWFNQ, LR	bfoikcwfnq lr
AKM, Y	akm y
BTFN, Y	btfn y
FVY, H	fvy h
YBIDXXR, YUHR	ybidxxr yuhr
ML, JBOMPF	ml jbompf
DKLY, W	dkly w
IQBG, J	iqbg j
KY, OQ	ky oq
UY, WPL	uy wpl
GH, DCM	gh dcm
BG, NOIDI	bg noidi
I, FK	i fk
D, FP	d fp
DV, E	dv e
Q, I	q i
HG, WW	hg ww
AX, WQ	ax wq
LX, LCSIR	lx lcsir
A, H	a h
GDQKZ, G	gdqkz g
A, FL	a fl
FCK, R	fck r
S, GZ	s gz
F, E	f e
QDK, T	qdk t
V, E	v e
TSL, K	tsl k
N, EDEKNW	n edeknw
BCS, Q	bcs q
R, CBT	r cbt
J, G	j g
E, WW	e ww
X, CVH	x cvh
IFVC, O	ifvc o
M, H	m h
TW, U	tw u
R, Y	r y
LGRQWP, G	lgrqwp g
NRTN, G	nrtn g
O, O	o o
N, AY	n ay
H, RG	h rg
QZ, F	qz f
UIL, PUTVZ	uil putvz
S, W	s w
JT, B	jt b
GB, R	gb r
MG, OQIBANYLNCM	mg oqibanylncm
U, DUAV	u duav
J, MOP	j mop
DTFBP, I	dtfbp i
BVM, UIYPE	bvm uiype
POB, C	pob c
O, WIL	o wil
B, K	b k
ZZ, JHY	zz jhy
K, K	k k
O, OGX	o ogx
OFB, W	ofb w
D, F	d f
LKSB, D	lksb d
XOB, EBU	xob ebu
W, IW	w iw
JTFDEI, HU	jtfdei hu
B, KEI	b kei
YCJOXKPT, U	ycjoxkpt u
B, K	b k
T, KGBTNRC	t kgbtnrc
N, F	n f
DM, V	dm v
NWPEL, PC	nwpel pc
W, MRNF	w mrnf
VP, IZZRN	vp izzrn
P, KFAQ	p kfaq
OIK, RU	oik ru
OIXXOECQ, QR	oixxoecq qr
AH, H	ah h
SY, BIPUQ	sy bipuq
O, T	o t
U, UEPBIWI	u uepbiwi
GKPONFJ, Q	gkponfj q
BG, M	bg m
MU, UYV	mu uyv
H, ZX	h zx
T, W	t w
SU, J	su j
DHJGVZPMO, EOFIAP	dhjgvzpmo eofiap
QF, ZXR	qf zxr
OTF, WIS	otf wis
CFG, G	cfg g
R, JJ	r jj
M, JKJVO	m jkjvo
QB, CIL	qb cil
DN, CT	dn ct
GH, AL	gh al
PZ, OI	pz oi
DHF, NCJCQVAXS	dhf ncjcqvaxs
EJIR, WQWN	ejir wqwn
UDF, NFHPKG	udf nfhpkg
H, N	h n
U, JK	u jk
J, HD	j hd
KPAEN, D	kpaen d
T, LJ	t lj
U, C	u c
XVK, EP	xvk ep
W, AMY	w amy
VHWJQYW, Z	vhwjqyw z
O, JUTSR	o jutsr
U, WA	u wa
G, TUP	g tup
RV, JM	rv jm
LVKHUUC, CLS	lvkhuuc cls
FSS, LK	fss lk
G, NKB	g nkb
RNADNATM, QGIH	rnadnatm qgih
S, GO	s go
Z, ZAX	z zax
AR, C	ar c
LJ, U	lj u
W, MBOXWG	w mboxwg
RWQNBMICPY, Z	rwqnbmicpy z
CV, DJ	cv dj
EY, O	ey o
HD, MR	hd mr
FA, TRJ	fa trj
FJ, RTG	fj rtg
VB, H	vb h
X, U	x u
WN, Q	wn q
LZO, NQSYTUG	lzo nqsytug
TDQ, YH	tdq yh
EK, YLLPS	ek yllps
MF, I	mf i
R, G	r g
Q, H	q h
JELE, GDC	jele gdc
PL, JOH	pl joh
G, GQYISQ	g gqyisq
D, VZGKO	d vzgko
NXD, AXPQXYADN	nxd axpqxyadn
RIRJO, M	rirjo m
E, SEKSK	e seksk
TZ, S	tz s
K, AYDB	k aydb
H, D	h d
D, V	d v
LNCGV, OQZGDXAP	lncgv oqzgdxap
WJ, XQT	wj xqt
CK, Q	ck q
IYW, FBBA	iyw fbba
UBI, XMV	ubi xmv
QD, C	qd c
M, SG	m sg
C, Q	c q
P, LSFDWJKPM	p lsfdwjkpm
VYY, ID	vyy id
TR, BY	tr by
EP, QWZQYJ	ep qwzqyj
C, Y	c y
I, B	i b
PPW, G	ppw g
GL, TK	gl tk
RQ, RRYUQ	rq rryuq
K, ZRO	k zro
W, W	w w
GA, ABW	ga abw
MAWIREQ, F	mawireq f
QA, G	qa g
VF, L	vf l
SF, TZ	sf tz
Y, BR	y br
YTH, D	yth d
LJWK, R	ljwk r
D, W	d w
WMLN, DN	wmln dn
LVZ, Y	lvz y
E, ROOP	e roop
KH, WU	kh wu
H, A	h a
FX, MEH	fx meh
CL, D	cl d
D, AEZ	d aez
Q, YGO	q ygo
NIZ, X	niz x
L, FM	l fm
I, Z	i z
D, F	d f
HCZNLN, JOB	hcznln job
R, GEQC	r geqc
P, Y	p y
EHF, PS	ehf ps
I, X	i x
GW, PTGC	gw ptgc
JIWCCZ, K	jiwccz k
I, AXBI	i axbi
HLECV, CXJNVF	hlecv cxjnvf
L, B	l b
Z, NV	z nv
JTDM, YXD	jtdm yxd
KWN, T	kwn t
OZ, YKAT	oz ykat
AW, G	aw g
QR, X	qr x
POZ, T	poz t
K, FAS	k fas
H, SG	h sg
K, YNOHOK	k ynohok
EBK, NXBLNMYN	ebk nxblnmyn
NKGX, UAVH	nkgx uavh
MU, XZM	mu xzm
K, ZWPNJY	k zwpnjy
XK, URIMB	xk urimb
ED, Z	ed z
I, LZE	i lze
NJC, G	njc g
W, NDZ	w ndz
AQWNJPK, T	aqwnjpk t
OL, JR	ol jr
IC, M	ic m
R, F	r f
XGY, BROEYF	xgy broeyf
B, NNMB	b nnmb
O, F	o f
P, U	p u
D, O	d o
VYW, O	vyw o
IT, NPZI	it npzi
EW, K	ew k
Q, F	q f
VBEA, ZHG	vbea zhg
P, MBG	p mbg
V, HLU	v hlu
GXO, OOT	gxo oot
A, SV	a sv
U, TC	u tc
L, AY	l ay
J, CRWY	j crwy
V, BYQEIF	v byqeif
V, TE	v te
A, G	a g
H, T	h t
UZZG, T	uzzg t
EWO, PE	ewo pe
C, GT	c gt
B, BU	b bu
B, YQQMHMO	b yqqmhmo
QO, HL	qo hl
B, DXM	b dxm
RDE, Y	rde y
XKAI, HLJQYW	xkai hljqyw
PXFQ, TPQ	pxfq tpq
HL, UE	hl ue
O, FBZ	o fbz
GI, X	gi x
RQ, CMFDZ	rq cmfdz
VE, U	ve u
AN, KKKQS	an kkkqs
ATO, OAT	ato oat
WF, TB	wf tb
Y, SK	y sk
X, O	x o
F, S	f s
USULCETHAEWKKD, GQTM	usulcethaewkkd gqtm
O, VYPUW	o vypuw
F, AHIHHT	f ahihht
QHTAWCQ, W	qhtawcq w
V, L	v l
W, YLDL	w yldl
A, MQN	a mqn
ZXO, R	zxo r
RD, O	rd o
W, OJR	w ojr
Q, W	q w
T, C	t c
DO, YJNMI	do yjnmi
WSL, RR	wsl rr
Q, FN	q fn
EH, QED	eh qed
M, HRELIXEW	m hrelixew
OWMTWU, N	owmtwu n
MCHCJ, XKT	mchcj xkt
ZY, RZWZ	zy rzwz
CA, T	ca t
XDV, LZRBUDBJC	xdv lzrbudbjc
DU, NDY	du ndy
UZR, ZE	uzr ze
RIU, V	riu v
L, S	l s
TXD, RH	txd rh
EKE, B	eke b
E, ZPG	e zpg
KNX, LSZMKY	knx lszmky
AFGG, SQWFCN	afgg sqwfcn
DO, FZQMOTEZQQQ	do fzqmotezqqq
C, C	c c
TRAZ, U	traz u
GY, F	gy f
U, X	u x
FAS, VEAXNF	fas veaxnf
E, K	e k
GK, DIL	gk dil
H, JZHVEK	h jzhvek
QJ, L	qj l
XCF, ZZQIC	xcf zzqic
FLL, FNO	fll fno
L, O	l o
PS, VWAOBUREBFYC	ps vwaoburebfyc
GNZA, AEOBJOX	gnza aeobjox
BKTWJ, EXMXFQI	bktwj exmxfqi
PPI, QQ	ppi qq
VD, U	vd u
B, FXD	b fxd
HCLI, VVXDMOK	hcli vvxdmok
NFLB, XMRDYD	nflb xmrdyd
RSYL, R	rsyl r
LOQ, POMY	loq pomy
U, KYQAUV	u kyqauv
G, GY	g gy
CGL, IN	cgl in
HA, J	ha j
FHWJN, I	fhwjn i
PJ, IP	pj ip
W, P	w p
KO, QRHMUVF	ko qrhmuvf
T, ZYQ	t zyq
I, TLYUZ	i tlyuz
MV, NC	mv nc
D, F	d f
F, I	f i
OTUP, I	otup i
LVARYLPOKDK, CY	lvarylpokdk cy
Y, P	y p
X, YBTF	x ybtf
F, RP	f rp
CH, Q	ch q
GR, R	gr r
OF, G	of g
YRIN, YW	yrin yw
Z, E	z e
WTEOHLZ, CN	wteohlz cn
U, HIXQR	u hixqr
I, Q	i q
XW, F	xw f
YGKQ, K	ygkq k
EVH, Y	evh y
DT, XS	dt xs
FJPWEK, MTHF	fjpwek mthf
JK, CT	jk ct
JYMQ, IN	jymq in
IW, KYCV	iw kycv
S, MKAO	s mkao
ZTNH, IME	ztnh ime
IX, K	ix k
QQ, LP	qq lp
W, Q	w q
AK, T	ak t
O, B	o b
CB, C	cb c
H, L	h l
E, TW	e tw
RI, XBI	ri xbi
QQSBI, HSF	qqsbi hsf
BM, HUFMB	bm hufmb
R, MRE	r mre
J, KG	j kg
LYSQIP, UPTBETQ	lysqip uptbetq
ZH, I	zh i
TJF, FWT	tjf fwt
G, LS	g ls
X, YBOZ	x yboz
R, KXQA	r kxqa
RVPA, UJV	rvpa ujv
POKKIIJ, ZYV	pokkiij zyv
HWS, XXHHE	hws xxhhe
B, KTKNTBDM	b ktkntbdm
H, JN	h jn
TI, RN	ti rn
P, KY	p ky
A, NB	a nb
AHD, P	ahd p
EWN, E	ewn e
E, G	e g
UFY, JM	ufy jm
BP, PD	bp pd
RTL, DY	rtl dy
UV, NA	uv na
KB, LL	kb ll
W, LJ	w lj
R, EXEDMHK	r exedmhk
J, DQGQAHT	j dqgqaht
AGQBS, NGAKGY	agqbs ngakgy
N, XJCYJJF	n xjcyjjf
B, EKPDT	b ekpdt
A, JJE	a jje
P, H	p h
IQB, YSV	iqb ysv
V, ODF	v odf
LGBUMOTSZT, ZFC	lgbumotszt zfc
IY, NRKY	iy nrky
UWE, XU	uwe xu
H, QJT	h qjt
B, M	b m
YQT, VV	yqt vv
AH, SVEAHXVYS	ah sveahxvys
ANVIZGXGLUVDFVVSY, YGU	anvizgxgluvdfvvsy ygu
MUJRYCQ, OF	mujrycq of
GJ, UDBG	gj udbg
T, C	t c
QN, SL	qn sl
X, ZS	x zs
LY, DN	ly dn
I, D	i d
DLNLBS, VQHD	dlnlbs vqhd
GWR, AXV	gwr axv
ZHD, ESX	zhd esx
V, DSC	v dsc
ZJPRCKVEN, R	zjprckven r
SDLWW, B	sdlww b
IG, SU	ig su
NOS, NXKA	nos nxka
I, O	i o
HC, I	hc i
G, T	g t
GKIANIHC, S	gkianihc s
BE, UHNB	be uhnb
SOYMC, U	soymc u
J, B	j b
SE, XCN	se xcn
JE, JS	je js
J, BFFWSZ	j bffwsz
V, SW	v sw
QV, A	qv a
K, GY	k gy
HUGYH, MLW	hugyh mlw
PWTJ, W	pwtj w
NE, L	ne l
C, HT	c ht
V, DU	v du
MG, A	mg a
W, S	w s
QX, DFBNF	qx dfbnf
O, MXR	o mxr
Q, XM	q xm
Q, BTO	q bto
RYX, F	ryx f
G, NSPJL	g nspjl
SBN, ZS	sbn zs
B, IF	b if
FDM, R	fdm r
V, ASPXBFBT	v aspxbfbt
M, X	m x
CA, WSDRN	ca wsdrn
IITM, PTV	iitm ptv
RLNW, Q	rlnw q
LF, Z	lf z
P, R	p r
XU, N	xu n
U, Y	u y
OY, P	oy p
MP, I	mp i
TA, O	ta o
K, TZ	k tz
XT, SW	xt sw
Z, M	z m
Z, J	z j
XC, B	xc b
TR, DZS	tr dzs
U, WKEG	u wkeg
MY, XB	my xb
E, BIEX	e biex
CF, G	cf g
AP, L	ap l
VVEZ, NWII	vvez nwii
SFOYQ, K	sfoyq k
LP, L	lp l
TNYNU, FM	tnynu fm
LHF, W	lhf w
XQ, ARFPS	xq arfps
HJ, G	hj g
IBP, IE	ibp ie
UMCLF, IL	umclf il
ECDSHGNWIMJB, MA	ecdshgnwimjb ma
LDT, VFX	ldt vfx
V, S	v s
NS, QJE	ns qje
I, D	i d
IDJ, SEF	idj sef
A, D	a d
DOP, OA	dop oa
UEK, W	uek w
QHL, WMOZ	qhl wmoz
X, W	x w
JM, H	jm h
V, LSCES	v lsces
WI, U	wi u
GIR, A	gir a
FFGX, SO	ffgx so
P, T	p t
G, LC	g lc
N, NYX	n nyx
M, V	m v
G, N	g n
QOH, N	qoh n
RK, T	rk t
A, RT	a rt
XXPYA, ASHH	xxpya ashh
RRQ, U	rrq u
CQM, N	cqm n
XJB, MM	xjb mm
HNY, K	hny k
HN, I	hn i
XABQI, BI	xabqi bi
NHCHAII, KG	nhchaii kg
V, GNK	v gnk
JQ, VVM	jq vvm
BM, WJW	bm wjw
RPC, IH	rpc ih
V, GJ	v gj
PPSEAOICTG, OY	ppseaoictg oy
Q, NU	q nu
GKO, PZSNYFXF	gko pzsnyfxf
YVR, L	yvr l
U, S	u s
G, O	g o
Q, PZP	q pzp
XOW, R	xow r
K, SA	k sa
X, F	x f
WN, B	wn b
C, SI	c si
Y, BQ	y bq
X, U	x u
B, S	b s
Y, HC	y hc
A, IYU	a iyu
LM, X	lm x
X, SB	x sb
LTX, LF	ltx lf
GN, W	gn w
R, C	r c
PGR, IFC	pgr ifc
E, R	e r
A, JLJ	a jlj
R, WFXE	r wfxe
Y, Q	y q
AJDKU, IBNO	ajdku ibno
VVP, IXXBNF	vvp ixxbnf
J, ZPA	j zpa
FKY, YOYX	fky yoyx
L, O	l o
UVR, BG	uvr bg
N, WWG	n wwg
HJ, Y	hj y
W, U	w u
VB, WU	vb wu
Q, O	q o
J, ZA	j za
YZ, CX	yz cx
Y, O	y o
L, Y	l y
GUBBRRZ, QCON	gubbrrz qcon
G, OB	g ob
TOCME, LF	tocme lf
PX, NNBE	px nnbe
KBYFO, AKM	kbyfo akm
W, F	w f
ZWWMDAT, TI	zwwmdat ti
A, YN	a yn
I, F	i f
NSZU, HS	nszu hs
ZOI, LUZD	zoi luzd
YOH, WCBUP	yoh wcbup
QQ, BTYMVL	qq btymvl
IU, X	iu x
MYI, Z	myi z
ZRSU, W	zrsu w
W, PUVC	w puvc
SD, UGD	sd ugd
Q, F	q f
GGU, T	ggu t
RR, OGZ	rr ogz
VV, SFDFB	vv sfdfb
C, G	c g
MO, VKGK	mo vkgk
AVHIQT, B	avhiqt b
Y, BESF	y besf
T, Z	t z
DR, TS	dr ts
KQ, Q	kq q
VYEGMRHLJUP, SS	vyegmrhljup ss
DP, F	dp f
LD, L	ld l
G, N	g n
GWJA, L	gwja l
RGO, XGEURWSGCEKH	rgo xgeurwsgcekh
V, F	v f
V, WGM	v wgm
U, A	u a
ONK, KD	onk kd
FLX, P	flx p
LQ, O	lq o
GHMHAT, F	ghmhat f
M, VAGNJ	m vagnj
MQ, CJ	mq cj
R, J	r j
DL, T	dl t
GKLBXHU, SY	gklbxhu sy
ETQX, TXG	etqx txg
WX, NWCOL	wx nwcol
A, F	a f
Q, RGNS	q rgns
UZ, LFVDPTY	uz lfvdpty
T, QL	t ql
SUW, G	suw g
EHR, D	ehr d
KP, U	kp u
CWVE, TFV	cwve tfv
T, KHJS	t khjs
T, LM	t lm
RR, VHLV	rr vhlv
LK, S	lk s
LYI, TEMUUWJU	lyi temuuwju
NQ, G	nq g
RXOZ, KKWX	rxoz kkwx
XGRQ, NAKZ	xgrq nakz
N, BE	n be
X, HABXQ	x habxq
R, H	r h
BWC, IG	bwc ig
EYYI, J	eyyi j
PJZZM, QS	pjzzm qs
CXKUM, YQ	cxkum yq
G, QVIHG	g qvihg
KRP, XWUSGSF	krp xwusgsf
JEWXW, P	jewxw p
OBAEL, J	obael j
T, VEWPB	t vewpb
HU, HYV	hu hyv
D, E	d e
JAWIQ, DD	jawiq dd
Q, SUH	q suh
B, O	b o
VJHV, PVHEDOH	vjhv pvhedoh
Y, J	y j
SII, ZN	sii zn
UY, MMTD	uy mmtd
X, J	x j
TH, TOXL	th toxl
F, D	f d
PY, ZT	py zt
SE, EWF	se ewf
WR, KCBP	wr kcbp
YVDM, K	yvdm k
TV, P	tv p
O, UM	o um
S, EEO	s eeo
O, O	o o
L, V	l v
LAZTD, XOUPL	laztd xoupl
W, VIFF	w viff
ASQ, YRMUT	asq yrmut
O, NW	o nw
EQOB, A	eqob a
SI, BYXPN	si byxpn
N, H	n h
MLG, G	mlg g
Z, D	z d
L, AWZU	l awzu
N, AP	n ap
SN, Y	sn y
IPE, V	ipe v
PGB, VPH	pgb vph
SO, SVA	so sva
CO, MA	co ma
FHA, S	fha s
VTXA, IT	vtxa it
KE, K	ke k
U, HKRX	u hkrx
KKMGY, R	kkmgy r
G, N	g n
BN, QCEK	bn qcek
J, SE	j se
Y, YF	y yf
JMZKBR, WSS	jmzkbr wss
HS, MDO	hs mdo
UT, GAO	ut gao
CNLL, C	cnll c
KME, QVD	kme qvd
HUCIKPM, O	hucikpm o
L, F	l f
TNGZCLPE, G	tngzclpe g
GFB, FWSME	gfb fwsme
SANC, O	sanc o
S, XT	s xt
Z, YEQZJ	z yeqzj
G, YDUL	g ydul
OA, CQ	oa cq
I, WY	i wy
ILM, YWU	ilm ywu
AG, XHO	ag xho
RTN, ZEN	rtn zen
SJYJDXH, VE	sjyjdxh ve
LIKXYW, S	likxyw s
WX, WUIDY	wx wuidy
D, V	d v
X, Y	x y
E, HOTD	e hotd
SV, W	sv w
KKEQ, RKPK	kkeq rkpk
X, D	x d
LB, C	lb c
QUESOK, WVGMV	quesok wvgmv
M, U	m u
PP, H	pp h
MSDI, V	msdi v
N, ZG	n zg
CMJC, IC	cmjc ic
DAEU, F	daeu f
YUMMY, EBTOX	yummy ebtox
YQ, KWHT	yq kwht
C, YPNTN	c ypntn
HSZ, F	hsz f
C, JC	c jc
NTKGZ, Y	ntkgz y
P, A	p a
ZB, N	zb n
ZFP, SRNMR	zfp srnmr
JF, H	jf h
Q, YPV	q ypv
IZCU, ZN	izcu zn
VOCC, RVN	vocc rvn
JJPMM, L	jjpmm l
UC, P	uc p
MRCJ, Q	mrcj q
OXI, TBMLB	oxi tbmlb
V, GV	v gv
SDJ, UV	sdj uv
H, TH	h th
M, G	m g
S, Y	s y
S, M	s m
CNFNYR, DQUDXOWTUGGD	cnfnyr dqudxowtuggd
R, D	r d
D, Z	d z
Y, OLRDJT	y olrdjt
VHMDS, EPZ	vhmds epz
QYBWPAI, MH	qybwpai mh
PN, G	pn g
GD, O	gd o
DHDH, FXY	dhdh fxy
LFOED, HS	lfoed hs
K, IGZNKTEYPV	k igznkteypv
H, A	h a
XKUDNM, ASIEJB	xkudnm asiejb
QBUMC, KW	qbumc kw
GWAHW, Z	gwahw z
XM, OUGIBA	xm ougiba
A, O	a o
O, RK	o rk
C, USMXLXLK	c usmxlxlk
DL, PXKYWKA	dl pxkywka
F, XPFTUKSEO	f xpftukseo
DZ, I	dz i
CJUV, XQ	cjuv xq
R, W	r w
TFWH, B	tfwh b
KT, D	kt d
V, YTNCA	v ytnca
S, BSM	s bsm
YZ, V	yz v
QPSSI, IXHR	qpssi ixhr
OL, GCQ	ol gcq
ECEB, F	eceb f
MAMLBUBNUY, N	mamlbubnuy n
C, AFG	c afg
Z, FFREH	z ffreh
ICOF, P	icof p
E, T	e t
O, WO	o wo
C, NM	c nm
JHFMEUQXV, OTRGM	jhfmeuqxv otrgm
Y, E	y e
CKZ, H	ckz h
Q, M	q m
MKNXO, TPG	mknxo tpg
RFEL, QPBZS	rfel qpbzs
XWO, CT	xwo ct
TLZK, XSV	tlzk xsv
SZK, EBWLD	szk ebwld
F, FP	f fp
RP, K	rp k
C, O	c o
C, NIF	c nif
AQLXLVV, GOLT	aqlxlvv golt
ZPZRROKVK, QW	zpzrrokvk qw
ZLJ, Y	zlj y
GNUW, VU	gnuw vu
ITSMV, N	itsmv n
IH, T	ih t
OVY, D	ovy d
WS, P	ws p
U, GNIG	u gnig
JJHIH, WU	jjhih wu
J, G	j g
DA, TEM	da tem
ENCU, D	encu d
HW, IBL	hw ibl
A, DBM	a dbm
Y, KISCH	y kisch
ZAIS, GU	zais gu
TYL, MNW	tyl mnw
HFCJR, YT	hfcjr yt
WZ, W	wz w
DMZYM, S	dmzym s
M, JGPEDWCFNLSWJ	m jgpedwcfnlswj
W, VPAQ	w vpaq
ZLYLSNO, S	zlylsno s
B, VK	b vk
NDI, ZDU	ndi zdu
PR, M	pr m
VSY, KF	vsy kf
T, RZ	t rz
CGC, H	cgc h
LU, E	lu e
PNZ, Q	pnz q
N, FP	n fp
Z, IT	z it
V, UL	v ul
CV, XHXRY	cv xhxry
X, P	x p
QW, I	qw i
JXD, K	jxd k
M, CIEEQ	m cieeq
YL, CIE	yl cie
O, YMX	o ymx
M, H	m h
SI, S	si s
O, DJ	o dj
PKW, ZQ	pkw zq
L, MTOTC	l mtotc
GBC, TKT	gbc tkt
D, B	d b
CZ, S	cz s
A, XCLD	a xcld
RI, LV	ri lv
XAJX, S	xajx s
ATKHE, QPZX	atkhe qpzx
VS, NLUO	vs nluo
TS, DJDHKLU	ts djdhklu
JRLDXOG, WY	jrldxog wy
WODBR, JT	wodbr jt
IVSZRHNYJHVF, W	ivszrhnyjhvf w
JAC, AV	jac av
PIFS, WG	pifs wg
E, E	e e
FK, GGN	fk ggn
PUQ, V	puq v
GS, W	gs w
ODAJAM, M	odajam m
O, HB	o hb
E, V	e v
Z, EL	z el
UOW, QZ	uow qz
AOGFMU, TXG	aogfmu txg
HQKD, C	hqkd c
H, YWHYXZ	h ywhyxz
U, KZG	u kzg
DZXDGB, MQ	dzxdgb mq
D, NB	d nb
V, RU	v ru
JV, V	jv v
W, TCVKU	w tcvku
KE, JS	ke js
W, F	w f
L, F	l f
G, LIPR	g lipr
DZ, TTTLI	dz tttli
O, FMZ	o fmz
HQ, HU	hq hu
X, TXPGQS	x txpgqs
JH, XHMU	jh xhmu
EPRVDI, MWOQX	eprvdi mwoqx
BS, AH	bs ah
GWC, XYSPUZS	gwc xyspuzs
YQ, J	yq j
F, YBE	f ybe
ZDXTC, L	zdxtc l
Z, C	z c
BRIJ, ZBYJOZY	brij zbyjozy
AOR, PF	aor pf
AE, RQVDX	ae rqvdx
X, LRR	x lrr
F, M	f m
QQRP, LO	qqrp lo
Q, CUX	q cux
NDV, VV	ndv vv
M, QCX	m qcx
DN, I	dn i
FLLCTO, C	fllcto c
HVJGE, X	hvjge x
OGSDU, G	ogsdu g
BJ, R	bj r
G, MI	g mi
VWAZ, Y	vwaz y
HMD, ZJ	hmd zj
Y, WEQ	y weq
IRXLYZV, W	irxlyzv w
VYORJYND, T	vyorjynd t
A, KQ	a kq
SA, GQL	sa gql
AAXH, QI	aaxh qi
N, YN	n yn
UQV, QVILK	uqv qvilk
B, QDJON	b qdjon
HH, B	hh b
YU, KBI	yu kbi
GMU, Y	gmu y
M, JOUE	m joue
C, G	c g
W, IM	w im
L, ZW	l zw
X, MD	x md
MNJ, FBKL	mnj fbkl
R, I	r i
R, KRZMS	r krzms
YPP, CU	ypp cu
Y, HV	y hv
S, RQ	s rq
FIWP, E	fiwp e
UW, R	uw r
MVR, A	mvr a
U, YD	u yd
OYW, J	oyw j
W, J	w j
LI, BBZ	li bbz
WN, ORT	wn ort
M, RDCOAP	m rdcoap
WKGP, O	wkgp o
TOU, JSW	tou jsw
GOMGLPIGVLA, GCUZ	gomglpigvla gcuz
VG, JQM	vg jqm
GFH, AC	gfh ac
P, SJMKMA	p sjmkma
GVEU, T	gveu t
T, YOWR	t yowr
E, O	e o
H, J	h j
PKET, FRP	pket frp
J, C	j c
SPS, KDP	sps kdp
PYE, J	pye j
OMXWWR, UR	omxwwr ur
VCG, H	vcg h
O, MR	o mr
AJ, RQ	aj rq
JL, XWE	jl xwe
D, K	d k
W, IEWY	w iewy
KFVW, N	kfvw n
C, H	c h
NB, LDC	nb ldc
OKT, H	okt h
URUTQQ, X	urutqq x
A, I	a i
Y, J	y j
A, K	a k
IRC, TKXFNPGSOWXL	irc tkxfnpgsowxl
RIVSDF, F	rivsdf f
HGS, F	hgs f
FYOYPKIY, U	fyoypkiy u
SR, J	sr j
E, A	e a
PF, TS	pf ts
V, WYJEV	v wyjev
P, K	p k
RKJ, WCK	rkj wck
H, X	h x
REVMQQ, W	revmqq w
YW, BRP	yw brp
XM, NRQ	xm nrq
Q, I	q i
EBGMP, RL	ebgmp rl
HXGNP, IO	hxgnp io
GG, Q	gg q
RTZ, XTOZP	rtz xtozp
U, C	u c
JEC, DBL	jec dbl
A, TO	a to
RQNS, YP	rqns yp
IPCDFAR, ISYMAQO	ipcdfar isymaqo
TN, A	tn a
AVXW, PBYYNV	avxw pbyynv
NFYT, TUIWC	nfyt tuiwc
RVM, W	rvm w
VEJKCV, XKMC	vejkcv xkmc
WJ, K	wj k
JJXJH, F	jjxjh f
V, QDWS	v qdws
WDVQHSJP, M	wdvqhsjp m
G, N	g n
B, L	b l
A, F	a f
LMLIGQNK, N	lmligqnk n
TQ, T	tq t
G, KE	g ke
E, U	e u
VXE, O	vxe o
UBUBA, IU	ububa iu
A, D	a d
SRAC, X	srac x
FW, VBVG	fw vbvg
UYL, F	uyl f
KF, H	kf h
X, VNPH	x vnph
AWVA, UJ	awva uj
S, HHCPXZQ	s hhcpxzq
VKCKAE, UY	vkckae uy
KGOSR, ZWM	kgosr zwm
GU, BM	gu bm
T, KMB	t kmb
ABY, DS	aby ds
A, PQX	a pqx
G, ZOF	g zof
P, PQG	p pqg
ISFL, Z	isfl z
LBM, RHJ	lbm rhj
I, DPXG	i dpxg
JD, XX	jd xx
KP, FV	kp fv
Q, NO	q no
SM, I	sm i
JY, KOWUDXMEA	jy kowudxmea
H, RLHS	h rlhs
PY, G	py g
S, D	s d
E, UJHFK	e ujhfk
HQT, JQJ	hqt jqj
O, S	o s
A, YXBBVLJIOQ	a yxbbvljioq
BA, Y	ba y
ED, QEM	ed qem
SFTT, BQG	sftt bqg
F, T	f t
AO, PI	ao pi
LMUBVSO, VUCVLJEZSHEDF	lmubvso vucvljezshedf
VUQ, QL	vuq ql
MJM, B	mjm b
PI, Y	pi y
TCE, MM	tce mm
I, Q	i q
Z, M	z m
A, PB	a pb
I, OLAM	i olam
Q, IAHVBE	q iahvbe
FJNUUH, UQCQ	fjnuuh uqcq
ERDV, V	erdv v
D, TPZ	d tpz
XZRQ, BAXE	xzrq baxe
FFKIARP, AISP	ffkiarp aisp
R, C	r c
UL, SG	ul sg
CBBP, J	cbbp j
T, O	t o
VP, KF	vp kf
L, UFPW	l ufpw
DPF, S	dpf s
IFAPE, M	ifape m
CHRVT, F	chrvt f
CP, PWFU	cp pwfu
A, Z	a z
WOV, T	wov t
LXL, XZMP	lxl xzmp
VAHIR, NSYT	vahir nsyt
P, XA	p xa
TQ, UIG	tq uig
O, GZGZB	o gzgzb
JAS, I	jas i
P, ILNGF	p ilngf
L, WC	l wc
VA, WA	va wa
OU, Q	ou q
M, TDNI	m tdni
TZ, VURN	tz vurn
SMWY, L	smwy l
C, UADG	c uadg
XSSAWGE, EMXFHY	xssawge emxfhy
ZR, WVY	zr wvy
KB, RZQ	kb rzq
DQ, U	dq u
O, HLA	o hla
X, F	x f
ZNNB, AKQZRLF	znnb akqzrlf
OJ, NQEOZ	oj nqeoz
SACDK, OZ	sacdk oz
Q, NPA	q npa
IPLP, USUKV	iplp usukv
E, DGIQ	e dgiq
S, HEZWE	s hezwe
AN, U	an u
JT, BKF	jt bkf
ON, YZQ	on yzq
Q, W	q w
XL, GC	xl gc
WF, MN	wf mn
Q, UTX	q utx
DL, ZGPXHC	dl zgpxhc
BG, BDXX	bg bdxx
A, G	a g
V, Y	v y
K, ZLT	k zlt
WQYBDYC, HOV	wqybdyc hov
Z, VRG	z vrg
IADHDDD, S	iadhddd s
V, QZNNFSY	v qznnfsy
RBC, PW	rbc pw
CJ, L	cj l
I, Z	i z
JS, CD	js cd
QW, MB	qw mb
F, J	f j
M, J	m j
MF, W	mf w
Q, K	q k
IYUUWEN, QDJ	iyuuwen qdj
LQJG, PPPNXNC	lqjg pppnxnc
I, L	i l
B, HM	b hm
A, HBP	a hbp
OY, PJ	oy pj
J, WSPB	j wspb
OH, DE	oh de
CL, KN	cl kn
Y, OPKUQZ	y opkuqz
AWA, CHA	awa cha
GSKDAPSW, NO	gskdapsw no
MY, V	my v
CB, K	cb k
R, SRNMB	r srnmb
D, D	d d
FZAFYKDV, ZPSJ	fzafykdv zpsj
XSGA, W	xsga w
V, SA	v sa
E, QM	e qm
NRXOBH, C	nrxobh c
U, XWCN	u xwcn
LIE, DXU	lie dxu
J, RPC	j rpc
YB, NZ	yb nz
GWEW, L	gwew l
J, X	j x
H, S	h s
FJ, V	fj v
WX, OEYWOAUPT	wx oeywoaupt
JE, JZ	je jz
UZ, QOQP	uz qoqp
UIBU, RKJ	uibu rkj
G, D	g d
I, D	i d
MF, XGT	mf xgt
URF, H	urf h
LTG, RZZQNSTJ	ltg rzzqnstj
Y, W	y w
NWN, FRV	nwn frv
GS, HHVB	gs hhvb
MWL, WSRTWPBUT	mwl wsrtwpbut
NNP, S	nnp s
WBSX, C	wbsx c
ECOPB, T	ecopb t
R, STA	r sta
LQB, XSF	lqb xsf
K, BWDDXIIIU	k bwddxiiiu
R, DH	r dh
G, V	g v
T, PAC	t pac
QRQ, TC	qrq tc
H, QV	h qv
FXP, HXVSP	fxp hxvsp
PKQ, L	pkq l
XY, K	xy k
FF, JXLO	ff jxlo
ATL, T	atl t
B, JLFPIZTXHYJBXLNW	b jlfpiztxhyjbxlnw
LQOPC, T	lqopc t
I, NMBEA	i nmbea
LMNNP, FCL	lmnnp fcl
WQJUAZA, XP	wqjuaza xp
C, RG	c rg
GB, BQ	gb bq
FN, FBERNKP	fn fbernkp
SP, W	sp w
MYXMWP, PZF	myxmwp pzf
HQ, OG	hq og
OUTFYQEKAC, QY	outfyqekac qy
JIVLM, N	jivlm n
U, F	u f
MKVQJ, FTTD	mkvqj fttd
FM, L	fm l
WC, FCBQP	wc fcbqp
HSSXE, VROTSZO	hssxe vrotszo
KA, LIFPHTIDSEM	ka lifphtidsem
PRS, L	prs l
Q, ED	q ed
JQE, H	jqe h
FURUY, X	furuy x
TNL, KEM	tnl kem
UB, TY	ub ty
H, J	h j
N, TP	n tp
X, ZS	x zs
D, ZF	d zf
RFR, F	rfr f
QEJY, N	qejy n
BB, RDWXN	bb rdwxn
Y, M	y m
U, GHDCBL	u ghdcbl
ZLZZLJKNJE, OMB	zlzzljknje omb
D, ML	d ml
ZQA, KKBX	zqa kkbx
RQA, WC	rqa wc
Y, P	y p
GVRM, ROH	gvrm roh
FLVESKBXTCSNCV, NRLA	flveskbxtcsncv nrla
LIKGIFVM, H	likgifvm h
Z, ZB	z zb
B, G	b g
L, Q	l q
E, HO	e ho
TSRQ, WH	tsrq wh
JT, YW	jt yw
NUHZMGP, EWG	nuhzmgp ewg
KLT, Z	klt z
T, UK	t uk
Z, DKQHQ	z dkqhq
OSY, HU	osy hu
SI, QD	si qd
T, UTMDCN	t utmdcn
G, STFZKH	g stfzkh
Z, K	z k
EQRO, LTK	eqro ltk
ZRX, WE	zrx we
R, W	r w
H, QKAU	h qkau
GD, QSA	gd qsa
Q, Y	q y
ADOB, HAXYJ	adob haxyj
ISPSEJUZ, XH	ispsejuz xh
QRT, B	qrt b
KCNXY, W	kcnxy w
CA, TTEU	ca tteu
D, KBWB	d kbwb
C, JZ	c jz
E, K	e k
ZF, UEH	zf ueh
I, P	i p
V, QJND	v qjnd
VGBHG, FT	vgbhg ft
ONJTT, QNNBAXH	onjtt qnnbaxh
J, B	j b
ODW, J	odw j
BOV, T	bov t
J, LX	j lx
UO, B	uo b
S, TW	s tw
X, G	x g
U, VW	u vw
E, BN	e bn
UKW, P	ukw p
M, U	m u
ACZPWW, Q	aczpww q
U, YEM	u yem
D, TYM	d tym
X, BA	x ba
H, RTB	h rtb
VG, BAZBUQ	vg bazbuq
Q, H	q h
APHFKSW, BUS	aphfksw bus
JIQFT, FC	jiqft fc
SE, C	se c
V, ABNEPY	v abnepy
G, EVVBZQGGZVL	g evvbzqggzvl
R, NDD	r ndd
OKM, GLTG	okm gltg
OF, N	of n
W, YPIYC	w ypiyc
G, AVYMME	g avymme
LYC, Z	lyc z
ZSB, DRP	zsb drp
M, H	m h
R, NVDN	r nvdn
K, VC	k vc
NDN, BA	ndn ba
VFJF, RG	vfjf rg
N, B	n b
P, FWZ	p fwz
PFBIEQ, Q	pfbieq q
E, JP	e jp
LM, LO	lm lo
Z, HKP	z hkp
CS, ULL	cs ull
V, O	v o
C, IN	c in
S, D	s d
IQX, AODXYB	iqx aodxyb
PEI, A	pei a
FT, A	ft a
DA, FKQEH	da fkqeh
K, S	k s
SU, LPBC	su lpbc
U, SHHK	u shhk
K, JNLXGN	k jnlxgn
EIGRZPJE, VK	eigrzpje vk
W, MNF	w mnf
J, JZZFU	j jzzfu
OIHHDEDPJ, XNFJS	oihhdedpj xnfjs
X, K	x k
PREQ, JYP	preq jyp
YA, OP	ya op
M, B	m b
J, QXLWA	j qxlwa
JON, C	jon c
B, HA	b ha
S, G	s g
N, NRP	n nrp
Q, N	q n
M, VTVMC	m vtvmc
QOHC, UG	qohc ug
EQ, P	eq p
KWF, B	kwf b
F, BZYIDP	f bzyidp
U, YTKH	u ytkh
F, ALO	f alo
GXS, UD	gxs ud
P, GS	p gs
J, MP	j mp
V, R	v r
TR, HXDCRS	tr hxdcrs
O, IU	o iu
U, JG	u jg
HYNX, UT	hynx ut
X, EOQ	x eoq
K, FCOIQI	k fcoiqi
I, AU	i au
E, D	e d
S, IK	s ik
Z, PVD	z pvd
Q, N	q n
OWZ, A	owz a
T, PC	t pc
DI, Q	di q
U, X	u x
FF, WIG	ff wig
R, MHHT	r mhht
EG, B	eg b
KKX, NIE	kkx nie
U, O	u o
T, V	t v
F, ED	f ed
TFHQQH, SR	tfhqqh sr
E, M	e m
HG, S	hg s
D, YJHQDD	d yjhqdd
C, Z	c z
NL, PD	nl pd
BEX, IDBTUPI	bex idbtupi
DA, KQHYWV	da kqhywv
O, PK	o pk
DRIUU, E	driuu e
YDKG, L	ydkg l
ODORPE, JNZQ	odorpe jnzq
K, NS	k ns
N, D	n d
W, E	w e
V, ZHNETBY	v zhnetby
X, BSZ	x bsz
Z, GIFIC	z gific
GTA, LU	gta lu
RBE, IRI	rbe iri
Z, M	z m
J, T	j t
B, ZHH	b zhh
Y, C	y c
T, JPT	t jpt
L, X	l x
Q, C	q c
T, N	t n
L, RHML	l rhml
TJ, JKUM	tj jkum
CWTB, TD	cwtb td
JB, JY	jb jy
XTYFGC, DXXXQL	xtyfgc dxxxql
B, CFVSPNVYD	b cfvspnvyd
IHCRY, B	ihcry b
KWFL, IVU	kwfl ivu
I, I	i i
DRK, LDW	drk ldw
FWV, F	fwv f
Q, IHP	q ihp
N, CKD	n ckd
G, JMFR	g jmfr
TW, UTD	tw utd
DS, Q	ds q
PGL, SBPGXC	pgl sbpgxc
PL, LHO	pl lho
QEH, C	qeh c
CGBFS, ISSLAW	cgbfs isslaw
YX, PC	yx pc
N, H	n h
IK, H	ik h
BJLD, ZQ	bjld zq
UEGW, ORGW	uegw orgw
KVI, YLCGZ	kvi ylcgz
V, CPK	v cpk
DKW, SDREM	dkw sdrem
RWPOTVQ, J	rwpotvq j
WO, FOZKJLX	wo fozkjlx
IM, K	im k
ZG, PLJJ	zg pljj
BNPH, F	bnph f
AA, LI	aa li
PEF, BW	pef bw
S, C	s c
M, AA	m aa
ZE, TIQ	ze tiq
E, LSWO	e lswo
LVW, RLQA	lvw rlqa
M, VLKXQLE	m vlkxqle
GC, M	gc m
HV, XCK	hv xck
E, JCK	e jck
J, Y	j y
FHNY, LVW	fhny lvw
B, JRZLQ	b jrzlq
BAFKG, ZC	bafkg zc
Z, DLM	z dlm
VUYC, RJX	vuyc rjx
Q, X	q x
F, Z	f z
NVDO, LNS	nvdo lns
TY, Q	ty q
DEFTS, XIE	defts xie
W, R	w r
E, WZ	e wz
YAHMJOQI, M	yahmjoqi m
VO, YW	vo yw
CC, KBDY	cc kbdy
E, N	e n
KZ, M	kz m
M, MB	m mb
VZ, GKPJL	vz gkpjl
DQ, MPQ	dq mpq
C, W	c w
LF, K	lf k
B, M	b m
WXXR, ORO	wxxr oro
L, MQ	l mq
W, G	w g
DP, IP	dp ip
GCDBEOR, MTI	gcdbeor mti
X, TK	x tk
V, Z	v z
AGKGB, QP	agkgb qp
WOU, JTV	wou jtv
GHVHDHS, XMYFEZK	ghvhdhs xmyfezk
FFVQ, Z	ffvq z
EAN, CFM	ean cfm
XYTUP, GS	xytup gs
FBLHAHBCCA, JGTH	fblhahbcca jgth
R, HA	r ha
AT, Z	at z
SMCFVWEDCYH, RR	smcfvwedcyh rr
OI, EZXV	oi ezxv
FCIH, P	fcih p
N, GR	n gr
SPC, LKO	spc lko
H, LI	h li
Y, M	y m
OGH, K	ogh k
IXVMT, U	ixvmt u
O, GTN	o gtn
JCF, GH	jcf gh
Q, FYVH	q fyvh
I, KPZK	i kpzk
CMOV, A	cmov a
X, R	x r
I, PU	i pu
XPIQY, PW	xpiqy pw
VHK, IP	vhk ip
RF, J	rf j
Y, V	y v
N, E	n e
HCFIDBF, APKF	hcfidbf apkf
UOSEASNAGT, L	uoseasnagt l
OGOYFKVB, WPRMUB	ogoyfkvb wprmub
ZT, C	zt c
A, BU	a bu
CN, C	cn c
XCVNO, JWJ	xcvno jwj
G, ON	g on
L, JOGCUPN	l jogcupn
EOBU, R	eobu r
OBP, Y	obp y
A, M	a m
C, BK	c bk
SXX, WOPQKTF	sxx wopqktf
LNNED, XA	lnned xa
MPQTOHVL, BQQYY	mpqtohvl bqqyy
SAZRX, OTENORZA	sazrx otenorza
FWRJSNP, CY	fwrjsnp cy
G, H	g h
DPT, G	dpt g
L, ZF	l zf
SYD, ITUW	syd ituw
QU, JFV	qu jfv
AIW, I	aiw i
W, RAPX	w rapx
VUD, CJ	vud cj
IJFED, TNMRQ	ijfed tnmrq
PIK, P	pik p
X, K	x k
DN, AX	dn ax
JH, XA	jh xa
I, VKG	i vkg
M, JVW	m jvw
LZB, MCK	lzb mck
O, PNKPZEEZ	o pnkpzeez
CSRQ, ZPR	csrq zpr
Q, PZRDWU	q pzrdwu
CV, JV	cv jv
H, KMH	h kmh
K, F	k f
YVDX, RZO	yvdx rzo
QX, I	qx i
K, A	k a
KD, NBN	kd nbn
BR, XNYFHJMMNUYGX	br xnyfhjmmnuygx
NK, R	nk r
NAYO, IAJRG	nayo iajrg
KZ, VA	kz va
HITPN, V	hitpn v
C, CI	c ci
NMP, P	nmp p
Q, BQED	q bqed
Q, DP	q dp
WRM, W	wrm w
VAW, TRNVWQ	vaw trnvwq
HY, TJD	hy tjd
YPAP, D	ypap d
JDOT, YDZ	jdot ydz
WFJX, Y	wfjx y
FS, XK	fs xk
AB, KIX	ab kix
JMWNLCHY, F	jmwnlchy f
AOFCBW, GD	aofcbw gd
WWBRGTH, J	wwbrgth j
OJ, M	oj m
P, SL	p sl
ZB, ZT	zb zt
JJ, AWC	jj awc
ZVHM, MWV	zvhm mwv
RBHZI, QT	rbhzi qt
PTE, JHOI	pte jhoi
YZ, IGCH	yz igch
L, CG	l cg
JK, BA	jk ba
W, O	w o
PWKONMG, MMF	pwkonmg mmf
WFZ, K	wfz k
D, JMGL	d jmgl
IIBF, WTU	iibf wtu
REE, AJ	ree aj
IN, PNVZ	in pnvz
G, U	g u
OJN, X	ojn x
QJ, HE	qj he
L, I	l i
BZ, SHE	bz she
F, CDR	f cdr
TFE, P	tfe p
FER, AJFKQ	fer ajfkq
H, FJMTTIZY	h fjmttizy
VG, NIBN	vg nibn
W, IIWQ	w iiwq
QS, ABX	qs abx
C, RZUO	c rzuo
HXY, UMGRI	hxy umgri
TS, FRJKH	ts frjkh
FQJTR, UAG	fqjtr uag
ZJQWTLQM, X	zjqwtlqm x
A, A	a a
M, MZO	m mzo
ICYU, CA	icyu ca
S, KYQZHRLJNDNY	s kyqzhrljndny
S, CE	s ce
D, CT	d ct
J, FOMRPR	j fomrpr
L, DX	l dx
OFD, GD	ofd gd
BWEGD, EPTR	bwegd eptr
LMC, LV	lmc lv
JEIA, N	jeia n
JVDTTY, IXYSWHTDTG	jvdtty ixyswhtdtg
PI, SLKL	pi slkl
S, B	s b
PD, SQK	pd sqk
FY, R	fy r
O, LRI	o lri
E, WUKF	e wukf
F, Z	f z
H, UOHUHH	h uohuhh
RBD, Q	rbd q
S, R	s r
TO, H	to h
ISJU, G	isju g
XAB, E	xab e
LHH, LDKME	lhh ldkme
OBCZL, ANKT	obczl ankt
KALP, Z	kalp z
SMQ, NBEZNWX	smq nbeznwx
K, N	k n
APZV, JH	apzv jh
WSM, W	wsm w
R, F	r f
G, Y	g y
IEZUFEF, DQT	iezufef dqt
FTO, G	fto g
ICIVX, G	icivx g
XT, D	xt d
H, A	h a
GUI, TX	gui tx
K, R	k r
F, A	f a
YDT, O	ydt o
GYYYAYUM, T	gyyyayum t
M, HRTS	m hrts
FX, BSDR	fx bsdr
VL, PA	vl pa
D, XL	d xl
Y, AGS	y ags
V, XXEWDCK	v xxewdck
AU, KM	au km
B, VG	b vg
Y, D	y d
V, WKJ	v wkj
PB, B	pb b
Y, F	y f
QV, DDB	qv ddb
D, P	d p
UE, L	ue l
FOQ, A	foq a
GQFGFCI, TQLPWJBLSRN	gqfgfci tqlpwjblsrn
LX, X	lx x
O, L	o l
Y, QWA	y qwa
UD, VFRCAU	ud vfrcau
JNO, I	jno i
AB, Y	ab y
PB, VN	pb vn
B, JB	b jb
IG, DZIUF	ig dziuf
USQ, V	usq v
YW, WRO	yw wro
LT, ME	lt me
CPR, P	cpr p
GZ, EYU	gz eyu
NKVMM, HD	nkvmm hd
M, W	m w
J, U	j u
ZP, R	zp r
FQC, B	fqc b
F, OX	f ox
N, J	n j
DSDTULPK, QPVURNY	dsdtulpk qpvurny
DZZG, VU	dzzg vu
VTYKW, IFGKWMMI	vtykw ifgkwmmi
T, HV	t hv
V, I	v i
B, OOMM	b oomm
NJKA, WOKDVPLSAKDNEX	njka wokdvplsakdnex
QFQ, JQPB	qfq jqpb
FYWQLHP, JDU	fywqlhp jdu
C, C	c c
JPCIP, TG	jpcip tg
E, UH	e uh
W, YGB	w ygb
QO, O	qo o
CSURX, W	csurx w
MMZ, SP	mmz sp
Y, EUYDJAC	y euydjac
A, L	a l
U, I	u i
EI, LC	ei lc
L, UR	l ur
KG, P	kg p
KBU, N	kbu n
HAHEU, WDS	haheu wds
IN, FA	in fa
LEELH, V	leelh v
B, NBIW	b nbiw
XSUN, SJZF	xsun sjzf
R, OVBPSBO	r ovbpsbo
F, TN	f tn
YQ, WQLUN	yq wqlun
LC, CU	lc cu
N, SKB	n skb
KQ, XJ	kq xj
DGGN, SO	dggn so
C, H	c h
QE, MBWI	qe mbwi
WG, ZDI	wg zdi
M, I	m i
SVD, Q	svd q
U, CLRE	u clre
H, S	h s
OV, C	ov c
XLAYRPV, A	xlayrpv a
SROFCA, C	srofca c
G, RIHJ	g rihj
UHJ, I	uhj i
MH, C	mh c
X, R	x r
RD, AZWC	rd azwc
FHXB, YHA	fhxb yha
DUOC, D	duoc d
C, LOY	c loy
U, U	u u
S, PM	s pm
K, RI	k ri
AIN, IGQ	ain igq
H, IW	h iw
VPX, HYTJ	vpx hytj
FTK, PK	ftk pk
BZZ, GTH	bzz gth
JG, H	jg h
E, GW	e gw
OPIJNAD, LPUUU	opijnad lpuuu
YP, HC	yp hc
AG, Q	ag q
KHJBUJRX, ZTF	khjbujrx ztf
QZFPHGZ, DQ	qzfphgz dq
E, G	e g
M, ES	m es
YHK, GAM	yhk gam
CG, W	cg w
Y, FG	y fg
ZDR, VYY	zdr vyy
RRT, WTOVLSC	rrt wtovlsc
U, O	u o
OGKFGB, K	ogkfgb k
F, IGVVKHMM	f igvvkhmm
ZUPMDUERT, U	zupmduert u
SCNKXXO, Y	scnkxxo y
EN, VGKL	en vgkl
T, T	t t
UXAB, HWWJ	uxab hwwj
N, V	n v
I, QSO	i qso
H, J	h j
N, LJX	n ljx
T, UCGQCX	t ucgqcx
JUA, L	jua l
HILMB, E	hilmb e
OJKP, EJ	ojkp ej
V, AD	v ad
TUZ, TAM	tuz tam
RBCKK, C	rbckk c
M, J	m j
H, H	h h
BX, PRVK	bx prvk
XWU, XJE	xwu xje
WPZUAR, C	wpzuar c
R, TEIB	r teib
D, IN	d in
HBT, AEXSK	hbt aexsk
QBZHP, JG	qbzhp jg
YXX, O	yxx o
D, REHX	d rehx
IFI, VZY	ifi vzy
L, O	l o
K, P	k p
Q, P	q p
OSTS, G	osts g
PA, XV	pa xv
E, GPY	e gpy
W, O	w o
BXCV, LESKL	bxcv leskl
EZ, C	ez c
M, LWY	m lwy
X, YWQQTJ	x ywqqtj
NOYKB, YW	noykb yw
P, BZ	p bz
UXFHZ, O	uxfhz o
ASDH, MAUUEJP	asdh mauuejp
TI, DM	ti dm
V, FGD	v fgd
W, Y	w y
CZ, X	cz x
QC, M	qc m
MRPFKS, SC	mrpfks sc
OKGEK, DH	okgek dh
GVQG, EVDX	gvqg evdx
KPWUJ, VIGJ	kpwuj vigj
B, P	b p
FTP, IHRD	ftp ihrd
DS, V	ds v
AXQVS, QNOOER	axqvs qnooer
B, C	b c
V, S	v s
FU, TTX	fu ttx
QIJQVAKG, SLX	qijqvakg slx
BJXNC, L	bjxnc l
UIYB, OQA	uiyb oqa
B, XPQVUVWB	b xpqvuvwb
QU, T	qu t
XX, R	xx r
P, H	p h
UTG, EKXBS	utg ekxbs
UEL, N	uel n
K, KESJ	k kesj
YRGEO, Y	yrgeo y
NYOIVE, M	nyoive m
N, RN	n rn
I, WI	i wi
CM, B	cm b
J, V	j v
H, HOA	h hoa
J, TD	j td
P, C	p c
OFEYUG, V	ofeyug v
A, FP	a fp
RMZPXE, RXZWZH	rmzpxe rxzwzh
E, IJJHNQZZ	e ijjhnqzz
S, HRF	s hrf
M, Z	m z
HN, GRX	hn grx
JO, BP	jo bp
JQWMSEF, AQ	jqwmsef aq
I, TTWT	i ttwt
NVJU, F	nvju f
L, TRX	l trx
BME, K	bme k
EQ, X	eq x
J, B	j b
K, H	k h
N, EKH	n ekh
GK, C	gk c
T, V	t v
XQAG, S	xqag s
N, F	n f
N, O	n o
O, F	o f
X, DVZ	x dvz
L, K	l k
JALHRMQ, RI	jalhrmq ri
M, S	m s
KW, YIB	kw yib
OI, PJ	oi pj
DG, T	dg t
VMY, T	vmy t
O, BPP	o bpp
Q, MSW	q msw
G, EH	g eh
EN, SEK	en sek
IA, OTUA	ia otua
P, FY	p fy
P, KE	p ke
MBV, CBV	mbv cbv
IM, G	im g
QL, M	ql m
LT, GMEDZ	lt gmedz
Z, EU	z eu
ITV, P	itv p
T, S	t s
GVJ, DQ	gvj dq
VNQS, M	vnqs m
C, LAS	c las
HRUADDOL, Z	hruaddol z
D, VKBPTJ	d vkbptj
OM, PF	om pf
UEIVW, K	ueivw k
S, LB	s lb
XB, Z	xb z
I, MB	i mb
OX, ETZ	ox etz
Z, HQE	z hqe
B, Y	b y
O, ZKDE	o zkde
LLV, GOKJTX	llv gokjtx
PH, EYH	ph eyh
EDJ, ITL	edj itl
S, HD	s hd
TL, Z	tl z
QV, KY	qv ky
LW, YNHLENYB	lw ynhlenyb
O, U	o u
CU, KKBA	cu kkba
NYMHUY, DNE	nymhuy dne
VZ, V	vz v
VMTDFV, XE	vmtdfv xe
RV, H	rv h
HA, E	ha e
TFBACKW, K	tfbackw k
EW, B	ew b
V, QOLJSUEW	v qoljsuew
EY, N	ey n
I, BXSH	i bxsh
Z, F	z f
W, NRCINU	w nrcinu
LERIHJTLH, S	lerihjtlh s
EZ, B	ez b
PN, T	pn t
JK, E	jk e
SJ, Z	sj z
P, T	p t
FFM, N	ffm n
GCEG, NO	gceg no
Y, IQ	y iq
B, MMUHQDSD	b mmuhqdsd
GSMY, OV	gsmy ov
T, F	t f
TD, H	td h
I, UB	i ub
XZZ, QWHPJM	xzz qwhpjm
C, AJ	c aj
T, I	t i
J, UMC	j umc
I, KTYRKT	i ktyrkt
WTY, EFG	wty efg
VINR, F	vinr f
Y, KXFTGL	y kxftgl
Y, SB	y sb
KRD, G	krd g
HHGFF, LEJ	hhgff lej
JMHPSX, KOCV	jmhpsx kocv
K, BX	k bx
KV, HHPOSDXGE	kv hhposdxge
C, P	c p
I, J	i j
RTULHM, QID	rtulhm qid
V, JM	v jm
UO, EZEH	uo ezeh
CGNYP, HS	cgnyp hs
XKKOV, TJWEWK	xkkov tjwewk
AFVTAS, JU	afvtas ju
JPU, F	jpu f
QCZHO, Z	qczho z
H, BL	h bl
BJ, FXUL	bj fxul
XXANXSIL, H	xxanxsil h
FWG, OBL	fwg obl
C, U	c u
C, IP	c ip
IH, FYNW	ih fynw
GQ, E	gq e
Q, MS	q ms
AF, DU	af du
D, P	d p
AMU, V	amu v
B, Y	b y
K, UAJTJW	k uajtjw
RJMRR, G	rjmrr g
FM, S	fm s
EZ, CU	ez cu
OI, EKPG	oi ekpg
P, D	p d
V, DYO	v dyo
I, RTDQ	i rtdq
APLIUD, WD	apliud wd
Y, J	y j
PJQX, M	pjqx m
TW, B	tw b
KN, WFX	kn wfx
B, B	b b
YA, NE	ya ne
CX, I	cx i
RD, KKJ	rd kkj
Y, CG	y cg
B, ZA	b za
QGQ, PAV	qgq pav
Y, MYSUDK	y mysudk
TA, JSGK	ta jsgk
Z, YXAC	z yxac
Z, SCCDKV	z sccdkv
NR, BRI	nr bri
NBJ, Y	nbj y
VF, C	vf c
QYR, XA	qyr xa
K, MJH	k mjh
SRDY, ZM	srdy zm
LJU, XSHRM	lju xshrm
UB, LAAFW	ub laafw
CX, NO	cx no
QR, EVOBV	qr evobv
WX, OXOF	wx oxof
QEHT, Z	qeht z
A, I	a i
G, GTY	g gty
QQUDR, J	qqudr j
JZQXU, V	jzqxu v
L, H	l h
NGW, GBT	ngw gbt
P, XI	p xi
NQ, CZOX	nq czox
X, H	x h
BOA, IZ	boa iz
AWZ, Y	awz y
NSLJAE, P	nsljae p
BQY, KHX	bqy khx
LX, K	lx k
DT, W	dt w
Q, I	q i
R, HKSYLX	r hksylx
ACXT, VV	acxt vv
CI, VBO	ci vbo
LZ, Y	lz y
EO, B	eo b
JGXI, FUJ	jgxi fuj
LK, G	lk g
TFDQTAU, J	tfdqtau j
IB, I	ib i
K, WV	k wv
VYPOLA, BLGC	vypola blgc
WVREJ, WZKDXW	wvrej wzkdxw
QKT, KOO	qkt koo
QU, D	qu d
WX, TROFDM	wx trofdm
I, ZZAM	i zzam
DQ, QF	dq qf
ZU, S	zu s
W, RCXILJFUV	w rcxiljfuv
OQC, G	oqc g
VX, B	vx b
OB, T	ob t
FLZDNI, I	flzdni i
PJ, DUW	pj duw
TN, II	tn ii
AQ, TGA	aq tga
U, Z	u z
K, D	k d
BFZ, YD	bfz yd
Q, TY	q ty
EY, O	ey o
S, GBWD	s gbwd
F, EB	f eb
CI, S	ci s
U, O	u o
CX, UADC	cx uadc
JC, FSO	jc fso
PPIBYEIGY, BY	ppibyeigy by
ZO, ZQ	zo zq
NW, S	nw s
P, Y	p y
Y, FYDSXWO	y fydsxwo
WJ, TWMDEAL	wj twmdeal
DPU, WWDJQFL	dpu wwdjqfl
NXDOXJ, JB	nxdoxj jb
L, WQXBY	l wqxby
BV, CZ	bv cz
LHX, WJ	lhx wj
UKOI, MU	ukoi mu
QX, V	qx v
E, N	e n
P, XURZ	p xurz
PCM, MXESXU	pcm mxesxu
VHTC, E	vhtc e
WWDR, QN	wwdr qn
GVVJIF, LQFDW	gvvjif lqfdw
B, N	b n
ELLE, AH	elle ah
B, Y	b y
LVUHRI, YM	lvuhri ym
YNL, EQRVKS	ynl eqrvks
A, C	a c
LY, GWFT	ly gwft
K, X	k x
QOJF, Z	qojf z
R, J	r j
B, H	b h
WT, O	wt o
QFPIR, USR	qfpir usr
C, H	c h
J, VH	j vh
HKN, XYD	hkn xyd
RG, ZZG	rg zzg
V, WD	v wd
B, W	b w
ALBSI, NWH	albsi nwh
WFM, DGC	wfm dgc
KNSM, B	knsm b
WZ, ZN	wz zn
KK, X	kk x
X, VXDRUZ	x vxdruz
QB, LOQZKT	qb loqzkt
SU, VKEJ	su vkej
IWLBPDVUBH, TT	iwlbpdvubh tt
IP, N	ip n
Z, J	z j
LS, V	ls v
Q, I	q i
ZGVHM, B	zgvhm b
SZ, Q	sz q
YWSD, T	ywsd t
EBB, A	ebb a
HFW, W	hfw w
REBVC, MF	rebvc mf
MB, MMK	mb mmk
LZWVDC, SXMFLTE	lzwvdc sxmflte
FMG, R	fmg r
E, OYUQX	e oyuqx
OZJGC, X	ozjgc x
RS, EYA	rs eya
OW, TXTQQ	ow txtqq
QHCY, I	qhcy i
V, UCU	v ucu
Z, UJZN	z ujzn
FA, W	fa w
UTHI, CEU	uthi ceu
GE, N	ge n
WRSE, CGFIU	wrse cgfiu
ERNQB, N	ernqb n
C, W	c w
YUYJPVA, TPQVTNU	yuyjpva tpqvtnu
TK, ECR	tk ecr
L, N	l n
N, P	n p
WLLIQB, S	wlliqb s
APSFM, FQJM	apsfm fqjm
ZS, Z	zs z
DN, NWJYUG	dn nwjyug
NHT, PQQ	nht pqq
UXCJURCXZLS, GO	uxcjurcxzls go
JNA, C	jna c
Y, NUAVCZYO	y nuavczyo
JQ, W	jq w
Y, P	y p
YR, NUI	yr nui
S, S	s s
H, UWXR	h uwxr
OHGLSMRRIAWOD, F	ohglsmrriawod f
P, TGN	p tgn
PG, A	pg a
P, I	p i
RS, P	rs p
PP, QY	pp qy
E, J	e j
GR, U	gr u
ZBNAXN, FN	zbnaxn fn
C, YH	c yh
G, OT	g ot
LEARETPVGE, UND	learetpvge und
E, E	e e
ZHYNN, I	zhynn i
EMIWG, GEE	emiwg gee
OHBMHI, N	ohbmhi n
CRS, AX	crs ax
VWD, QWLP	vwd qwlp
C, CSV	c csv
V, TWS	v tws
E, Q	e q
DFICD, IE	dficd ie
ZFAWNLPXTFP, ZZLJ	zfawnlpxtfp zzlj
CNUPETW, ZC	cnupetw zc
V, ZPHDPH	v zphdph
RJPLS, A	rjpls a
YSS, NKKL	yss nkkl
FWHS, X	fwhs x
CFJUN, CY	cfjun cy
BX, V	bx v
GAR, NHVZ	gar nhvz
JHEDOX, CO	jhedox co
PS, NAIL	ps nail
C, KWSY	c kwsy
R, CIP	r cip
HVHGA, E	hvhga e
Q, G	q g
Y, D	y d
H, KRQ	h krq
KEBZ, ASOCLEHC	kebz asoclehc
C, ZA	c za
VGYD, ZN	vgyd zn
U, BYRN	u byrn
MF, H	mf h
M, V	m v
QPA, V	qpa v
AE, SI	ae si
TL, YU	tl yu
GSR, GKSKFHG	gsr gkskfhg
XC, JXJ	xc jxj
N, ZY	n zy
LC, J	lc j
U, G	u g
UCOENBB, IJS	ucoenbb ijs
Y, M	y m
QW, Z	qw z
BT, OCKR	bt ockr
CYVW, KRK	cyvw krk
DGYPX, Y	dgypx y
Y, AOL	y aol
JTHG, JH	jthg jh
HPKK, X	hpkk x
FK, OV	fk ov
ZKMC, GIAZWC	zkmc giazwc
FMEQGW, XWB	fmeqgw xwb
VO, XOEVBE	vo xoevbe
K, Q	k q
DCIE, AZ	dcie az
KV, G	kv g
TUGR, VNBR	tugr vnbr
DKPBQU, M	dkpbqu m
E, AS	e as
WUYQ, BI	wuyq bi
R, I	r i
L, M	l m
TNN, QNZHG	tnn qnzhg
E, SN	e sn
ZCNOEG, J	zcnoeg j
BFO, JI	bfo ji
C, E	c e
COXGF, GMYI	coxgf gmyi
C, R	c r
ITLG, EM	itlg em
PDM, A	pdm a
IMV, P	imv p
OYX, X	oyx x
P, V	p v
B, N	b n
FMZUF, HET	fmzuf het
L, WVKJ	l wvkj
SR, KD	sr kd
IP, W	ip w
T, HLT	t hlt
IV, Y	iv y
C, ZQZNILS	c zqznils
CUB, P	cub p
RV, QD	rv qd
MT, G	mt g
ZQ, GO	zq go
JKW, PNGUMLI	jkw pngumli
NVZF, GXWDHK	nvzf gxwdhk
PZY, E	pzy e
ATEZWERSFK, KCDYH	atezwersfk kcdyh
ND, A	nd a
COSML, E	cosml e
SY, JQJN	sy jqjn
XLEVIZ, M	xleviz m
P, FS	p fs
B, M	b m
IE, R	ie r
F, JX	f jx
QQ, FUO	qq fuo
T, VW	t vw
U, GLAR	u glar
ZE, KNHHO	ze knhho
VXLF, MOOHWZ	vxlf moohwz
NTW, UW	ntw uw
GANL, B	ganl b
P, OE	p oe
XIPP, SMYEH	xipp smyeh
KTTIL, PJCEVI	kttil pjcevi
X, RXTL	x rxtl
KP, K	kp k
H, QKT	h qkt
SDAK, C	sdak c
A, L	a l
EQBFXY, ELEI	eqbfxy elei
L, VGG	l vgg
JL, R	jl r
J, PYUAJK	j pyuajk
KTFH, KFPHZ	ktfh kfphz
E, AG	e ag
RL, QZMLQWEIZAZQD	rl qzmlqweizazqd
QUVZG, XX	quvzg xx
P, E	p e
MB, D	mb d
DI, IMB	di imb
URWV, NN	urwv nn
Q, WMX	q wmx
W, I	w i
FNE, CFEN	fne cfen
Q, EQ	q eq
B, VYC	b vyc
AKC, IRCU	akc ircu
XXJQEU, A	xxjqeu a
Y, HU	y hu
KN, K	kn k
H, EMW	h emw
NLU, K	nlu k
A, Y	a y
W, KO	w ko
MK, A	mk a
HNXND, AMH	hnxnd amh
BXJDRWJTV, MI	bxjdrwjtv mi
X, BD	x bd
VE, T	ve t
N, GFLMO	n gflmo
L, IDC	l idc
V, FP	v fp
ZZAXY, WO	zzaxy wo
H, E	h e
U, EONGBWPGE	u eongbwpge
UC, EWGVV	uc ewgvv
NFHOYJG, W	nfhoyjg w
JEV, VFP	jev vfp
WASKEOZXARBPD, N	waskeozxarbpd n
EM, G	em g
PD, S	pd s
I, OY	i oy
U, SGV	u sgv
ZVD, ZRUEXHN	zvd zruexhn
S, KKP	s kkp
E, I	e i
RC, EPR	rc epr
O, JCOL	o jcol
XU, LLZDK	xu llzdk
S, R	s r
S, HYTGCXDVFH	s hytgcxdvfh
OV, Z	ov z
XLLRGW, QS	xllrgw qs
AG, B	ag b
QBY, UHX	qby uhx
QJFOIERI, IRSHN	qjfoieri irshn
TLMZ, D	tlmz d
V, ZTS	v zts
O, V	o v
LTBP, OIBPA	ltbp oibpa
T, B	t b
WY, VA	wy va
V, V	v v
A, KZZY	a kzzy
BM, HHOKH	bm hhokh
SBU, XM	sbu xm
L, NB	l nb
BXWFU, KKJ	bxwfu kkj
IDZ, LDY	idz ldy
TB, SDA	tb sda
R, P	r p
F, TP	f tp
VJZEC, GD	vjzec gd
EVEK, E	evek e
I, R	i r
WW, CY	ww cy
Q, B	q b
DD, W	dd w
DFQ, VQ	dfq vq
W, FF	w ff
AF, GY	af gy
Y, NIL	y nil
T, Q	t q
L, DQC	l dqc
D, Y	d y
IW, X	iw x
HI, DI	hi di
Z, D	z d
C, O	c o
BENHK, N	benhk n
GKZTAL, XTK	gkztal xtk
II, X	ii x
EKKS, Q	ekks q
UJKRZVLPL, DKA	ujkrzvlpl dka
TP, E	tp e
IU, T	iu t
W, NAXC	w naxc
M, L	m l
H, HCM	h hcm
O, PO	o po
URYBU, O	urybu o
Z, PZ	z pz
BKRNT, RNE	bkrnt rne
RV, B	rv b
VL, G	vl g
R, AOFTFTE	r aoftfte
NBIW, IJQ	nbiw ijq
VVHOIWWOS, MZM	vvhoiwwos mzm
GYWY, RKMHX	gywy rkmhx
QW, AF	qw af
S, U	s u
P, XF	p xf
DG, J	dg j
VGGC, JLMPFAMZC	vggc jlmpfamzc
G, REZA	g reza
PPLN, XOUL	ppln xoul
X, WBVVV	x wbvvv
ZG, FFO	zg ffo
RGKXCD, Q	rgkxcd q
WN, DD	wn dd
PKXL, PC	pkxl pc
LVX, B	lvx b
ZX, NFI	zx nfi
B, VP	b vp
FVKZG, PKYNV	fvkzg pkynv
C, Y	c y
R, JZ	r jz
LC, UDH	lc udh
K, F	k f
K, PAKUCTM	k pakuctm
WB, VZE	wb vze
VK, SNQLE	vk snqle
VAJ, UB	vaj ub
TI, P	ti p
T, E	t e
HNKVGHJ, AC	hnkvghj ac
X, CGOR	x cgor
D, AINHOE	d ainhoe
NU, R	nu r
A, Y	a y
V, OCEJSR	v ocejsr
ZER, M	zer m
Z, JK	z jk
H, DATOJ	h datoj
EI, CN	ei cn
W, IIBF	w iibf
BK, FU	bk fu
O, C	o c
QGTI, Y	qgti y
J, D	j d
KGG, TV	kgg tv
FFM, YGW	ffm ygw
R, J	r j
SB, I	sb i
WYI, W	wyi w
QZHV, B	qzhv b
SQ, DFKN	sq dfkn
VQRIKI, EUT	vqriki eut
F, KP	f kp
Y, EMGGXSQ	y emggxsq
Q, DOP	q dop
SCBO, Q	scbo q
BHW, Y	bhw y
JEN, DL	jen dl
R, Y	r y
F, A	f a
ROG, BYH	rog byh
G, S	g s
H, V	h v
D, FY	d fy
L, BFE	l bfe
N, G	n g
KB, J	kb j
DXR, B	dxr b
Y, MC	y mc
ZE, DLPQ	ze dlpq
PBDWLRZ, JSV	pbdwlrz jsv
ZIWZKTLCUBCEB, B	ziwzktlcubceb b
FHDLDUVBJCDUR, PJ	fhdlduvbjcdur pj
S, CR	s cr
TE, DUIW	te duiw
O, K	o k
NMZ, AHB	nmz ahb
TGVMH, U	tgvmh u
C, ZPF	c zpf
TE, A	te a
O, SDASU	o sdasu
FNDX, RL	fndx rl
J, AM	j am
HNUR, THT	hnur tht
G, DD	g dd
TZ, XPOK	tz xpok
F, CP	f cp
EGDLO, Q	egdlo q
A, W	a w
R, SV	r sv
GC, P	gc p
K, BFB	k bfb
D, RLNN	d rlnn
J, K	j k
GFJV, TXL	gfjv txl
WGP, BK	wgp bk
ZNAFRER, TTF	znafrer ttf
HJQ, J	hjq j
ZACXYV, YOWQ	zacxyv yowq
FF, V	ff v
U, Y	u y
YW, UUTB	yw uutb
CZ, U	cz u
X, UMJD	x umjd
Y, FV	y fv
T, THYQ	t thyq
PG, VF	pg vf
XLFF, B	xlff b
HSUE, I	hsue i
TP, F	tp f
Z, E	z e
S, BVO	s bvo
LZQ, AC	lzq ac
M, SQ	m sq
NCG, U	ncg u
T, D	t d
EUO, Y	euo y
DY, LW	dy lw
K, T	k t
M, EHJ	m ehj
NHJZAJ, QVM	nhjzaj qvm
U, H	u h
ZUPUJQT, G	zupujqt g
BX, RK	bx rk
GN, NU	gn nu
RPWN, IM	rpwn im
II, J	ii j
A, P	a p
B, E	b e
AL, MS	al ms
SR, ZVEHPHBP	sr zvehphbp
PTA, ZV	pta zv
ZN, VY	zn vy
EDNXZW, K	ednxzw k
T, GQJ	t gqj
REZB, RTU	rezb rtu
N, PK	n pk
OT, UIVS	ot uivs
TKDS, XHOC	tkds xhoc
X, D	x d
IC, LTB	ic ltb
UH, EODA	uh eoda
IPZV, ST	ipzv st
XA, J	xa j
JYTB, ICUZDM	jytb icuzdm
PQFDURO, X	pqfduro x
X, F	x f
ZDT, XV	zdt xv
Y, TJYG	y tjyg
I, HKG	i hkg
CAC, ZEXS	cac zexs
NSFTA, G	nsfta g
M, YLD	m yld
N, SSDI	n ssdi
C, F	c f
YC, K	yc k
ME, OZ	me oz
UKTPATYLQ, A	uktpatylq a
X, VM	x vm
T, QEV	t qev
JTW, UASBKD	jtw uasbkd
MLOEPVVE, UH	mloepvve uh
CA, CFT	ca cft
AHJR, A	ahjr a
WG, U	wg u
GO, I	go i
BRSJDBN, SJRC	brsjdbn sjrc
B, IN	b in
ABS, INM	abs inm
IQ, LSJX	iq lsjx
J, S	j s
ZQBU, A	zqbu a
U, BZL	u bzl
S, XJKJBEEBIBOTPUL	s xjkjbeebibotpul
HNDH, CD	hndh cd
WCYSMOFR, AC	wcysmofr ac
DHDN, NOT	dhdn not
SNCX, L	sncx l
M, W	m w
FOY, TS	foy ts
LVW, IVR	lvw ivr
XJ, R	xj r
ULXZOMMQWAPKXZ, RD	ulxzommqwapkxz rd
NOKDGGSA, ME	nokdggsa me
XTDWR, Y	xtdwr y
XXAPEMF, T	xxapemf t
O, HSI	o hsi
VN, YZ	vn yz
XLXBP, AQH	xlxbp aqh
XG, Y	xg y
VWA, YTJEP	vwa ytjep
NW, BW	nw bw
HMOE, M	hmoe m
CC, NPKP	cc npkp
SEE, A	see a
DLA, Q	dla q
IES, JH	ies jh
BEA, Z	bea z
TQ, GNVT	tq gnvt
Y, TJAK	y tjak
ESCKY, ETITQZK	escky etitqzk
X, D	x d
J, LEOFZAKXNH	j leofzakxnh
GAXONKW, F	gaxonkw f
Y, BTXI	y btxi
K, YC	k yc
TN, JRWB	tn jrwb
YTZUZV, KF	ytzuzv kf
M, GTTD	m gttd
D, ZUOPI	d zuopi
EJ, B	ej b
OQJ, TLU	oqj tlu
T, QPCBGON	t qpcbgon
E, JBDQQG	e jbdqqg
E, BE	e be
NYB, SOD	nyb sod
KI, UZE	ki uze
MRLJO, LBXSJ	mrljo lbxsj
PG, YRK	pg yrk
E, XP	e xp
V, M	v m
L, HO	l ho
CE, UU	ce uu
N, QG	n qg
ZCHG, HJFIYFXNRZVL	zchg hjfiyfxnrzvl
MJ, KI	mj ki
FXI, PWL	fxi pwl
N, M	n m
H, R	h r
JZ, BLFC	jz blfc
F, T	f t
DFM, IFKFETKMRE	dfm ifkfetkmre
C, LS	c ls
EV, CI	ev ci
F, STX	f stx
H, Z	h z
AIQ, J	aiq j
ZF, O	zf o
WK, QN	wk qn
QRT, QEN	qrt qen
RI, PY	ri py
HSTHUUAP, VR	hsthuuap vr
YS, H	ys h
EU, LUUHKVM	eu luuhkvm
G, RAT	g rat
F, QL	f ql
KJ, X	kj x
G, L	g l
Z, SODN	z sodn
E, PPX	e ppx
FKI, H	fki h
T, CT	t ct
HLNLSO, M	hlnlso m
MBM, PN	mbm pn
X, T	x t
TG, A	tg a
NCXH, QX	ncxh qx
JSV, NDQDB	jsv ndqdb
MRGT, IKIA	mrgt ikia
JY, C	jy c
J, J	j j
BD, C	bd c
B, I	b i
O, WB	o wb
H, D	h d
IFWJ, IV	ifwj iv
C, JLB	c jlb
R, J	r j
BGTZYFZVL, ML	bgtzyfzvl ml
ZT, HGKZ	zt hgkz
CGZNTIQM, GB	cgzntiqm gb
QKF, OK	qkf ok
IIU, T	iiu t
H, H	h h
K, TL	k tl
NJL, C	njl c
UJ, FU	uj fu
XA, XJOY	xa xjoy
N, Y	n y
S, CBMITZD	s cbmitzd
Z, ELJV	z eljv
I, SFY	i sfy
AZV, WB	azv wb
R, RHYYJ	r rhyyj
ZUW, AN	zuw an
JL, U	jl u
SJAM, A	sjam a
YYAS, SDFN	yyas sdfn
FJ, KXF	fj kxf
PQS, VOAOGFR	pqs voaogfr
C, M	c m
CYB, E	cyb e
I, E	i e
BK, H	bk h
LGL, W	lgl w
V, OICANQ	v oicanq
NGDEOWG, FEWYT	ngdeowg fewyt
E, GN	e gn
TCRZJGA, Y	tcrzjga y
L, SZE	l sze
G, O	g o
TC, LPIHFAS	tc lpihfas
KVFIZ, CP	kvfiz cp
L, WSV	l wsv
M, RK	m rk
IGSY, T	igsy t
G, M	g m
SZ, FJIGYT	sz fjigyt
KNL, IIJ	knl iij
B, DZYP	b dzyp
AP, DJYS	ap djys
BCA, DKU	bca dku
WD, C	wd c
IPVIIR, WL	ipviir wl
F, Q	f q
A, L	a l
R, SOR	r sor
FXD, E	fxd e
KX, UKI	kx uki
F, L	f l
TL, F	tl f
P, AW	p aw
JR, E	jr e
RMTZFE, K	rmtzfe k
TRFJD, A	trfjd a
WT, S	wt s
ER, HXG	er hxg
S, BTZELOGAGT	s btzelogagt
CE, PRE	ce pre
XN, SI	xn si
Q, Q	q q
L, C	l c
B, Y	b y
S, F	s f
FK, LOB	fk lob
FMO, R	fmo r
KOUORWQDYQG, W	kouorwqdyqg w
BBV, VJM	bbv vjm
EKKN, MY	ekkn my
X, H	x h
M, J	m j
Y, MNX	y mnx
MTMMKAB, MFVEFGFF	mtmmkab mfvefgff
RQWLXXMZLC, B	rqwlxxmzlc b
HS, P	hs p
ICWD, HOE	icwd hoe
O, RD	o rd
ALU, WYH	alu wyh
PLW, YEC	plw yec
LK, K	lk k
B, AVQUEK	b avquek
A, EARHP	a earhp
EU, L	eu l
FXV, LG	fxv lg
UZ, EF	uz ef
A, FS	a fs
DWFOTHZ, MDSBQ	dwfothz mdsbq
X, XGMEMRM	x xgmemrm
A, EOJNFZPPA	a eojnfzppa
VD, R	vd r
HGF, ND	hgf nd
E, KA	e ka
CWCOL, SVI	cwcol svi
EK, JZ	ek jz
LPZOX, GJP	lpzox gjp
CC, G	cc g
P, I	p i
GF, X	gf x
M, NAGNUBL	m nagnubl
MKC, PI	mkc pi
E, UCH	e uch
LOHR, K	lohr k
JNRRNV, O	jnrrnv o
RMWC, NOQU	rmwc noqu
C, X	c x
X, E	x e
P, K	p k
N, XUQ	n xuq
H, O	h o
WO, F	wo f
BB, U	bb u
UY, A	uy a
TV, Z	tv z
TJ, L	tj l
M, YY	m yy
HL, SCAK	hl scak
T, Y	t y
M, SXJDNENZIM	m sxjdnenzim
H, WWZ	h wwz
R, RRVN	r rrvn
T, IJQOVRTN	t ijqovrtn
NYGXCER, JQ	nygxcer jq
RXU, W	rxu w
YHT, BH	yht bh
J, G	j g
K, XOA	k xoa
FIF, BN	fif bn
RW, DSIH	rw dsih
C, ZC	c zc
JNS, I	jns i
KE, PVD	ke pvd
FSV, CQY	fsv cqy
I, WQ	i wq
S, M	s m
K, D	k d
CEZDSJFU, VN	cezdsjfu vn
I, Y	i y
M, N	m n
BPVE, V	bpve v
J, QRK	j qrk
DDG, JSA	ddg jsa
RP, GLUNF	rp glunf
V, WOEHKH	v woehkh
F, XV	f xv
V, X	v x
BL, BFWV	bl bfwv
NOSD, S	nosd s
G, HE	g he
N, RZ	n rz
YU, J	yu j
RA, RQDPZAF	ra rqdpzaf
TI, IHA	ti iha
ATXGKQ, H	atxgkq h
ROA, HJ	roa hj
B, I	b i
JPCXN, A	jpcxn a
WRH, W	wrh w
SFB, F	sfb f
W, H	w h
LLN, EE	lln ee
JE, M	je m
R, D	r d
CJYA, EOM	cjya eom
K, WFGWU	k wfgwu
UDB, VE	udb ve
P, LQ	p lq
X, E	x e
U, WUKC	u wukc
LRW, J	lrw j
BEY, OA	bey oa
Q, YS	q ys
N, D	n d
TBUK, V	tbuk v
VH, NL	vh nl
Y, E	y e
N, VY	n vy
F, I	f i
A, GS	a gs
F, U	f u
NEJ, N	nej n
H, CV	h cv
Q, Z	q z
B, VB	b vb
A, B	a b
Q, GTMVUCQON	q gtmvucqon
M, NTK	m ntk
O, CBSVM	o cbsvm
P, BC	p bc
QQC, G	qqc g
YZQZK, GES	yzqzk ges
CF, JUY	cf juy
S, SJKOIFD	s sjkoifd
Z, SJN	z sjn
MGV, DYFP	mgv dyfp
YT, Z	yt z
X, FB	x fb
V, F	v f
S, SYLQHV	s sylqhv
AX, Y	ax y
ZOFY, J	zofy j
UZJ, RQAVZ	uzj rqavz
V, JOPB	v jopb
QA, K	qa k
QQN, E	qqn e
Z, IR	z ir
F, WU	f wu
SPS, J	sps j
G, MIQ	g miq
T, Z	t z
N, YME	n yme
C, N	c n
M, MXLKG	m mxlkg
B, PPHJP	b pphjp
CXU, N	cxu n
LREZH, J	lrezh j
BW, F	bw f
SP, T	sp t
RP, NLR	rp nlr
YQV, M	yqv m
QOL, RFPL	qol rfpl
EC, MI	ec mi
ZVHDWY, XD	zvhdwy xd
MAU, JZDKW	mau jzdkw
EWZS, H	ewzs h
DR, M	dr m
FGYQBZN, D	fgyqbzn d
YC, FBNF	yc fbnf
TRJR, YB	trjr yb
WNQUD, U	wnqud u
WUMG, SFZG	wumg sfzg
YN, QF	yn qf
W, MAP	w map
XT, W	xt w
NDXE, NJMIJD	ndxe njmijd
VM, P	vm p
M, X	m x
Q, F	q f
N, FI	n fi
LE, XISELY	le xisely
ALSL, E	alsl e
XE, THP	xe thp
DMUS, JT	dmus jt
VDFS, DWRX	vdfs dwrx
L, WMJH	l wmjh
ACWN, LZ	acwn lz
AV, LN	av ln
PUGCH, M	pugch m
CLYRQO, ZZDS	clyrqo zzds
VOISJMXBI, C	voisjmxbi c
A, UAA	a uaa
A, G	a g
W, Q	w q
O, GH	o gh
HIBTKH, KFR	hibtkh kfr
CR, IFEXOWEOQSYS	cr ifexoweoqsys
ZFU, UAXHO	zfu uaxho
T, QM	t qm
IP, X	ip x
GOYBNFX, BE	goybnfx be
U, P	u p
Q, MU	q mu
R, DOX	r dox
KI, YOD	ki yod
IXQ, ZWD	ixq zwd
G, HJS	g hjs
XD, GUU	xd guu
J, DXC	j dxc
B, S	b s
X, P	x p
XJMMJWQ, OIXJXXVUACKJARP	xjmmjwq oixjxxvuackjarp
Y, UUVD	y uuvd
WSBMP, OEUR	wsbmp oeur
TLM, MKDHHO	tlm mkdhho
K, TN	k tn
BY, DI	by di
A, RMM	a rmm
SV, F	sv f
BIRUZ, HOZXAJ	biruz hozxaj
NTWO, VOAYLW	ntwo voaylw
RPN, OJ	rpn oj
SMZXW, V	smzxw v
VIZVPCX, VOSVNUECI	vizvpcx vosvnueci
FML, PCR	fml pcr
ESMB, G	esmb g
NM, V	nm v
XKBA, V	xkba v
R, ADCPNMP	r adcpnmp
BD, SXS	bd sxs
YB, DZCNPOB	yb dzcnpob
AKP, X	akp x
IBV, C	ibv c
GKTF, V	gktf v
B, NA	b na
T, Q	t q
UKW, KOXHE	ukw koxhe
W, SAGXX	w sagxx
U, E	u e
JT, RRJ	jt rrj
O, NYQ	o nyq
U, CM	u cm
PPTLAI, EEBYVF	pptlai eebyvf
V, U	v u
KWF, LH	kwf lh
EY, N	ey n
O, LTPI	o ltpi
CU, E	cu e
FN, USR	fn usr
VZUILE, X	vzuile x
Z, BISI	z bisi
AY, ZO	ay zo
PL, JM	pl jm
QN, T	qn t
KWB, RXAK	kwb rxak
UANJAZV, J	uanjazv j
VUH, AZ	vuh az
E, HUD	e hud
L, LCZ	l lcz
H, TB	h tb
SR, NO	sr no
MJ, BED	mj bed
E, BPBKL	e bpbkl
PQ, ULQ	pq ulq
W, IPO	w ipo
W, A	w a
HO, KSRJBUU	ho ksrjbuu
IHT, F	iht f
KJUR, Q	kjur q
T, DPFQ	t dpfq
R, SE	r se
XS, XTA	xs xta
XQYV, Q	xqyv q
MB, GMUDHXMDYQ	mb gmudhxmdyq
C, JATZ	c jatz
X, OTHW	x othw
DE, LRB	de lrb
M, Z	m z
E, ZS	e zs
J, CR	j cr
T, EV	t ev
E, LD	e ld
LP, C	lp c
H, WQ	h wq
AC, BPU	ac bpu
HZJ, F	hzj f
UD, OMN	ud omn
KRJRMXCSH, J	krjrmxcsh j
VGTMYEO, C	vgtmyeo c
ONXICA, Q	onxica q
YBQ, K	ybq k
N, O	n o
T, D	t d
M, ZASN	m zasn
DWYTCH, GTI	dwytch gti
JB, I	jb i
RGGCG, GE	rggcg ge
BJ, Z	bj z
UQE, F	uqe f
Q, Q	q q
MIWK, R	miwk r
C, Q	c q
RI, PE	ri pe
J, XT	j xt
RQMW, K	rqmw k
U, Y	u y
NFPMF, BS	nfpmf bs
H, AS	h as
EZOSD, ELT	ezosd elt
VFJ, NO	vfj no
HEGLTX, XNV	hegltx xnv
RHOGBFU, XMD	rhogbfu xmd
GXWEY, B	gxwey b
HZ, IUBQS	hz iubqs
Z, H	z h
K, XYIMV	k xyimv
QD, ODDT	qd oddt
Z, Q	z q
CYYWK, OYJIH	cyywk oyjih
JO, I	jo i
I, R	i r
FVP, UP	fvp up
RBI, YHKAO	rbi yhkao
V, PV	v pv
F, UXY	f uxy
S, V	s v
Z, H	z h
UJ, XYB	uj xyb
SXLR, R	sxlr r
QX, YBCUDVK	qx ybcudvk
A, FKKHQMG	a fkkhqmg
BR, MMP	br mmp
T, XMZ	t xmz
UVMY, T	uvmy t
UH, DEP	uh dep
MQBY, AEFPDT	mqby aefpdt
WY, V	wy v
RO, W	ro w
O, QKVWU	o qkvwu
HXLKCRLLDME, AYXHUT	hxlkcrlldme ayxhut
D, X	d x
NVPDY, Z	nvpdy z
O, D	o d
OHMM, EAU	ohmm eau
ZOBYM, CLRPYZ	zobym clrpyz
V, C	v c
ESIQFD, DV	esiqfd dv
L, TYBRTSKMEP	l tybrtskmep
N, DOULWK	n doulwk
AMHD, L	amhd l
TCB, BCX	tcb bcx
LMM, U	lmm u
DRVPJWX, XW	drvpjwx xw
ID, Z	id z
VOCXMN, R	vocxmn r
S, V	s v
MA, NTM	ma ntm
ZV, B	zv b
CXXQ, CTB	cxxq ctb
J, YM	j ym
TQZYX, V	tqzyx v
LLWX, ZHBU	llwx zhbu
AK, Q	ak q
A, R	a r
B, S	b s
AA, U	aa u
A, LYP	a lyp
T, NNQQ	t nnqq
QD, A	qd a
Y, L	y l
CG, AT	cg at
VT, U	vt u
E, M	e m
SWJIELF, ML	swjielf ml
Q, CR	q cr
S, MZ	s mz
A, BS	a bs
UVO, M	uvo m
S, LG	s lg
B, A	b a
NFA, N	nfa n
EZKW, TO	ezkw to
B, WF	b wf
VNM, CQ	vnm cq
B, X	b x
G, TYDTV	g tydtv
N, H	n h
LDJQ, Y	ldjq y
W, R	w r
K, UWZR	k uwzr
J, ADLEI	j adlei
Q, R	q r
C, K	c k
EOFZOEY, E	eofzoey e
AZ, P	az p
N, WZ	n wz
A, E	a e
YYJ, Q	yyj q
PVE, Z	pve z
HYM, ND	hym nd
IW, X	iw x
GE, FT	ge ft
AB, J	ab j
RXV, JN	rxv jn
X, TAZI	x tazi
T, ZYH	t zyh
Z, L	z l
XMGS, V	xmgs v
P, N	p n
P, HLF	p hlf
M, TKC	m tkc
V, K	v k
KQC, F	kqc f
K, RBF	k rbf
SD, H	sd h
M, ZEDOHWV	m zedohwv
OZ, SZ	oz sz
W, EFWHSLYLPAPA	w efwhslylpapa
O, AVY	o avy
Z, K	z k
AAS, QPH	aas qph
O, TJ	o tj
X, TFK	x tfk
FC, BT	fc bt
OQK, I	oqk i
LW, P	lw p
V, HXV	v hxv
JK, C	jk c
R, MBGZHZ	r mbgzhz
TWPH, N	twph n
AC, SD	ac sd
XL, OBL	xl obl
SEF, Z	sef z
CJOPCS, PNN	cjopcs pnn
NPSN, M	npsn m
IHT, DSG	iht dsg
RGXG, G	rgxg g
REJHY, K	rejhy k
UCIQ, T	uciq t
QBGA, BMJ	qbga bmj
CY, MZ	cy mz
CTGOGK, DE	ctgogk de
WWYCCS, PCLG	wwyccs pclg
A, L	a l
KWBF, ZH	kwbf zh
Z, PN	z pn
P, Z	p z
Q, UNXCB	q unxcb
GDLB, FEY	gdlb fey
CFEVXIT, UZV	cfevxit uzv
EVO, MNJDVEEM	evo mnjdveem
J, J	j j
A, J	a j
NJV, C	njv c
P, IKSI	p iksi
L, CZD	l czd
S, A	s a
IS, B	is b
YQ, J	yq j
XGIP, M	xgip m
I, EYB	i eyb
E, C	e c
LGCM, PE	lgcm pe
WDQ, AO	wdq ao
F, RF	f rf
D, ZQCB	d zqcb
J, E	j e
J, UDQYNG	j udqyng
W, KNCU	w kncu
IWSTS, KOMH	iwsts komh
PW, NB	pw nb
G, M	g m
UA, J	ua j
FUU, P	fuu p
FM, HYA	fm hya
YKMQ, T	ykmq t
O, O	o o
PO, X	po x
A, NER	a ner
CBXI, ZZX	cbxi zzx
FOGFFV, ODJEWHNI	fogffv odjewhni
DA, RY	da ry
JB, EPTG	jb eptg
G, ECD	g ecd
RZU, F	rzu f
QF, QZNK	qf qznk
Y, K	y k
H, SLK	h slk
ZSK, EW	zsk ew
U, YA	u ya
NJM, GICBD	njm gicbd
IXWRO, KJ	ixwro kj
Q, K	q k
O, P	o p
W, E	w e
VVEMINYI, C	vveminyi c
M, MPDC	m mpdc
S, BYQU	s byqu
KM, ZRA	km zra
NX, YEPRJSED	nx yeprjsed
ZOJBPI, R	zojbpi r
Y, VOD	y vod
JQM, HRSC	jqm hrsc
ZT, EAM	zt eam
S, K	s k
CF, WVZBAJ	cf wvzbaj
UZ, C	uz c
NGJV, B	ngjv b
D, CR	d cr
B, GN	b gn
LV, HC	lv hc
Z, RCNJ	z rcnj
N, CFVBX	n cfvbx
DOD, L	dod l
AES, YN	aes yn
C, H	c h
VE, Q	ve q
ZUG, DY	zug dy
V, FZM	v fzm
SVVMJVCENEMBPA, VN	svvmjvcenembpa vn
QNW, V	qnw v
RA, DX	ra dx
O, L	o l
GCTL, IOAQTAAL	gctl ioaqtaal
JP, H	jp h
TASSKT, GO	tasskt go
C, C	c c
FY, XR	fy xr
PB, V	pb v
Y, C	y c
Q, GN	q gn
DIUT, ZVJU	diut zvju
QBWLPCKH, I	qbwlpckh i
KGB, Z	kgb z
Z, Y	z y
XU, EBK	xu ebk
H, KMR	h kmr
ZQXH, G	zqxh g
J, LOD	j lod
BJH, FM	bjh fm
OC, V	oc v
OV, QB	ov qb
S, Z	s z
VYZF, E	vyzf e
FYH, T	fyh t
VJ, ZT	vj zt
GIN, AO	gin ao
C, KVFJY	c kvfjy
MWWB, DDUM	mwwb ddum
J, KIIEJB	j kiiejb
VSHSQX, FYKE	vshsqx fyke
NHYFH, YRJFS	nhyfh yrjfs
MTRX, T	mtrx t
N, YRHBDSEFKW	n yrhbdsefkw
GC, K	gc k
T, KJOB	t kjob
W, VI	w vi
K, WVBP	k wvbp
O, NOYB	o noyb
VYSFWSWSHNVI, Q	vysfwswshnvi q
KP, C	kp c
QSX, YCL	qsx ycl
K, JJ	k jj
QPIULMOGK, E	qpiulmogk e
JFCEEINMHD, ZUAR	jfceeinmhd zuar
YZW, S	yzw s
HMFKET, E	hmfket e
AVCE, QF	avce qf
HETUAMZDFSE, F	hetuamzdfse f
C, DPKD	c dpkd
MKD, E	mkd e
V, XE	v xe
GILPBC, O	gilpbc o
PU, IX	pu ix
SFB, AF	sfb af
NWXFJ, PGYPZMHZN	nwxfj pgypzmhzn
D, MPAK	d mpak
MN, W	mn w
LY, I	ly i
E, PPLYQ	e pplyq
F, FCS	f fcs
E, ZN	e zn
QV, I	qv i
WO, XXWTT	wo xxwtt
PX, YKY	px yky
PTAD, Q	ptad q
E, G	e g
RGYM, UQ	rgym uq
Y, PLT	y plt
JAYQ, DDM	jayq ddm
X, HU	x hu
G, CKTHY	g ckthy
UKTAPGXJ, KN	uktapgxj kn
N, W	n w
JGQA, OK	jgqa ok
E, Z	e z
UK, FPQTAIU	uk fpqtaiu
OUF, Z	ouf z
IGAO, WPE	igao wpe
P, D	p d
FO, DC	fo dc
Z, R	z r
DG, OKB	dg okb
BV, WEA	bv wea
BD, GAGC	bd gagc
XG, G	xg g
JSCKXSIY, E	jsckxsiy e
RGZD, J	rgzd j
UM, QXJNX	um qxjnx
EMPWN, P	empwn p
ZZBXA, I	zzbxa i
FSU, JMD	fsu jmd
MW, N	mw n
MXLJKE, BO	mxljke bo
H, F	h f
DS, FM	ds fm
UJ, FTE	uj fte
J, D	j d
RKKVMN, K	rkkvmn k
VIY, T	viy t
WFV, TME	wfv tme
KANU, PWFN	kanu pwfn
RD, E	rd e
I, AC	i ac
R, KCJ	r kcj
G, F	g f
O, N	o n
SJU, ZUG	sju zug
RTT, N	rtt n
VAG, A	vag a
VI, UHZ	vi uhz
HPV, B	hpv b
RWSUEO, DWKH	rwsueo dwkh
FB, EK	fb ek
F, UAI	f uai
SMHAB, Q	smhab q
MEU, T	meu t
RNK, O	rnk o
Z, QZQJ	z qzqj
UY, DJHNYZ	uy djhnyz
GNISY, FEJPVXDBK	gnisy fejpvxdbk
KO, LIGS	ko ligs
ELNEPW, R	elnepw r
XETJ, W	xetj w
OMBNZ, G	ombnz g
LF, DWLJGKTJ	lf dwljgktj
S, PU	s pu
SHFRC, QU	shfrc qu
U, M	u m
OMF, PDK	omf pdk
O, O	o o
BQ, NZM	bq nzm
B, Z	b z
J, Q	j q
STRKLE, VD	strkle vd
MPNN, G	mpnn g
GBZRGW, FZE	gbzrgw fze
F, WI	f wi
ODQ, XEHEY	odq xehey
PWMC, K	pwmc k
Q, MQS	q mqs
NP, T	np t
FQW, AFM	fqw afm
PPX, TZN	ppx tzn
OPBBU, VNU	opbbu vnu
S, SEXNLCY	s sexnlcy
W, D	w d
NWW, MU	nww mu
XRJE, LP	xrje lp
W, Y	w y
L, X	l x
G, X	g x
PCVBSJC, H	pcvbsjc h
N, V	n v
NA, H	na h
AXI, FM	axi fm
S, AZ	s az
E, LJ	e lj
QXB, T	qxb t
GDMFF, MPQ	gdmff mpq
AAEBWV, E	aaebwv e
TWBX, CRK	twbx crk
A, UOBIEE	a uobiee
XP, PHIX	xp phix
G, WP	g wp
K, GSS	k gss
NAE, Y	nae y
ALXR, P	alxr p
BWM, JLGU	bwm jlgu
CVOW, Q	cvow q
HXY, ZJAA	hxy zjaa
IMRA, VOVM	imra vovm
CZCJET, CO	czcjet co
V, TA	v ta
HAT, OW	hat ow
W, XSAUSZE	w xsausze
PGFHNDEV, Y	pgfhndev y
NJETP, F	njetp f
VBUR, YON	vbur yon
OV, I	ov i
S, P	s p
HM, CG	hm cg
TQJ, J	tqj j
HBQ, H	hbq h
JHRHH, JAFB	jhrhh jafb
N, G	n g
JIP, VVQ	jip vvq
G, R	g r
P, J	p j
IH, FS	ih fs
CSXQ, S	csxq s
LU, LM	lu lm
DX, UQZQLK	dx uqzqlk
WCJFZWXDW, X	wcjfzwxdw x
AOB, UZ	aob uz
OZ, DPPH	oz dpph
XWWZCFAIX, U	xwwzcfaix u
NGTD, UC	ngtd uc
XRD, DEIEIT	xrd deieit
YAN, A	yan a
S, BG	s bg
STXHJBM, LKK	stxhjbm lkk
PDD, V	pdd v
RWUQG, F	rwuqg f
X, EF	x ef
I, YVH	i yvh
IINRB, VDUMQX	iinrb vdumqx
N, M	n m
DJAB, WZ	djab wz
U, L	u l
VF, C	vf c
PK, QL	pk ql
DEAVCTLG, CYO	deavctlg cyo
DUGLZ, MXH	duglz mxh
H, H	h h
Z, H	z h
DU, SDP	du sdp
TK, YW	tk yw
SSY, AN	ssy an
WCTJ, NJ	wctj nj
XW, O	xw o
KKPZ, A	kkpz a
ARVQ, K	arvq k
NQKC, UI	nqkc ui
ACVJYBWLB, J	acvjybwlb j
RAHS, HS	rahs hs
I, ZRO	i zro
Q, P	q p
SD, XI	sd xi
CWY, KQS	cwy kqs
D, T	d t
W, DB	w db
ST, H	st h
XT, HKNW	xt hknw
C, CDE	c cde
TG, IC	tg ic
CV, DRCLB	cv drclb
V, XP	v xp
SEPGHLTJF, HX	sepghltjf hx
P, FGYRTLQ	p fgyrtlq
R, F	r f
K, WN	k wn
J, ID	j id
J, ERTA	j erta
WOV, EIQY	wov eiqy
RXCR, W	rxcr w
VTNKQQ, PG	vtnkqq pg
CU, MHOWO	cu mhowo
FNJ, LP	fnj lp
SNWY, Q	snwy q
CFMP, HK	cfmp hk
IFS, TUJ	ifs tuj
IOQ, X	ioq x
IMR, W	imr w
JRCTY, J	jrcty j
UY, P	uy p
CNYHVWX, KQKV	cnyhvwx kqkv
R, BGHH	r bghh
GPF, H	gpf h
C, KNNK	c knnk
E, OP	e op
W, W	w w
GC, L	gc l
O, GQNDXVPUWQ	o gqndxvpuwq
N, Z	n z
F, V	f v
V, X	v x
GZHD, KNR	gzhd knr
QKR, CSIS	qkr csis
S, D	s d
R, DTE	r dte
GA, TXET	ga txet
D, MVR	d mvr
WIRORGSP, XM	wirorgsp xm
ZF, Z	zf z
QX, HC	qx hc
BG, GXNDSW	bg gxndsw
D, Y	d y
RF, LVG	rf lvg
S, QKYSD	s qkysd
N, KGMZXM	n kgmzxm
DD, WA	dd wa
WJ, VGK	wj vgk
X, WS	x ws
U, VTVXBQONKT	u vtvxbqonkt
KGJ, U	kgj u
QVZ, D	qvz d
PAUXLONNLPAKR, R	pauxlonnlpakr r
ME, N	me n
LD, HSFLXUN	ld hsflxun
YLVHVGXC, FBMD	ylvhvgxc fbmd
PE, KY	pe ky
RKWSKMD, E	rkwskmd e
X, QA	x qa
QT, JGJX	qt jgjx
QN, IE	qn ie
KB, WL	kb wl
O, DAZQT	o dazqt
B, TBSGUJ	b tbsguj
ED, U	ed u
YP, R	yp r
Q, IVF	q ivf
GUMBH, V	gumbh v
YZC, T	yzc t
BDB, JT	bdb jt
Q, K	q k
A, VTZN	a vtzn
OYSSXYXN, R	oyssxyxn r
XQG, EMBSIJ	xqg embsij
F, DJPVTP	f djpvtp
XJ, F	xj f
YX, O	yx o
G, NXF	g nxf
JBG, GKG	jbg gkg
AZQLPRZ, H	azqlprz h
Y, A	y a
BZ, I	bz i
G, E	g e
ZGA, XQFFCRNZISG	zga xqffcrnzisg
D, EGNM	d egnm
OVHIW, G	ovhiw g
I, D	i d
DU, N	du n
S, T	s t
NW, E	nw e
V, WR	v wr
UZ, UYWHOSN	uz uywhosn
T, JWYO	t jwyo
D, PMAM	d pmam
WQ, CIT	wq cit
JV, O	jv o
YTY, DC	yty dc
S, GL	s gl
H, T	h t
J, WJX	j wjx
DK, MYP	dk myp
YCOM, JST	ycom jst
DTNTFK, YQURW	dtntfk yqurw
U, L	u l
NLL, Q	nll q
I, LWG	i lwg
Y, D	y d
C, ZV	c zv
FLMG, X	flmg x
W, ULV	w ulv
Y, F	y f
X, PMQ	x pmq
T, N	t n
UV, XOGT	uv xogt
Z, JG	z jg
HYUE, AD	hyue ad
Z, DVSV	z dvsv
PG, R	pg r
G, U	g u
J, WZCX	j wzcx
VMC, ERBT	vmc erbt
LZH, T	lzh t
YED, YT	yed yt
MFU, N	mfu n
APLVJ, ELG	aplvj elg
K, YC	k yc
WBWPIT, ROVLGO	wbwpit rovlgo
U, GZNRKI	u gznrki
BMCH, S	bmch s
UFIZZQM, B	ufizzqm b
A, SN	a sn
F, HB	f hb
A, RZU	a rzu
N, R	n r
LGDJ, Q	lgdj q
WA, VDCUQ	wa vdcuq
Q, C	q c
Q, B	q b
BK, TB	bk tb
KV, DD	kv dd
E, G	e g
RD, MV	rd mv
Q, MCI	q mci
R, S	r s
KSKFNSOE, KF	kskfnsoe kf
BPYWIPWTAX, IR	bpywipwtax ir
HB, Q	hb q
ACCGY, VK	accgy vk
Z, W	z w
UVTEDVO, FXVOV	uvtedvo fxvov
OZPRZ, R	ozprz r
D, U	d u
H, ZMS	h zms
QQNCM, TSLY	qqncm tsly
WJ, EYOLRB	wj eyolrb
YP, H	yp h